species,mtdna.length,cds.count.ncbi,trna.count.ncbi,rrna.count.ncbi,sum
Oryzias minutillus,16953,13,22,2,37
Oryzias dancena,16863,13,22,2,37
Oryzias luzonensis,16666,13,22,2,37
Ammothea carolinensis,15101,13,22,2,37
Oryzias javanicus,16892,13,22,2,37
Cottus poecilopus,16560,13,22,2,37
Candida prachuapensis,90840,18,25,2,45
Ithaginis cruentus,16683,13,22,2,37
Petrochromis trewavasae,16588,13,22,2,37
Tropheus moorii,16590,13,22,2,37
Luciogobius platycephalus,16478,13,22,2,37
Paralithodes camtschaticus,16720,13,22,2,37
Epinephelus fuscoguttatus,16648,13,22,2,37
Hyporthodus octofasciatus,16545,13,22,2,37
Moschus chrysogaster,16353,13,22,2,37
Nannochloropsis oceanica,38057,35,25,2,62
Issoria lathonia,15172,13,22,2,37
Butomus umbellatus,450826,30,16,4,50
Aegilops speltoides var. ligustica,476091,34,25,10,69
Triticum timopheevii,443419,35,23,8,66
Variola louti,16770,13,23,2,38
Variola albimarginata,16768,13,23,2,38
Triso dermopterus,16605,13,22,2,37
Cephalopholis argus,16767,13,23,2,38
Cephalopholis sonnerati,16587,13,22,2,37
Glomus cerebriforme,59633,20,25,2,47
Oocatochus rufodorsatus,17159,13,22,2,37
Enophrys diceraus,16976,13,22,2,37
Orectolobus japonicus,16706,13,22,2,37
Spinibarbus caldwelli,16545,13,22,2,37
Emberiza aureola,16800,13,22,2,37
Candida blackwelliae,32053,14,24,2,40
Candida chauliodis,77153,19,24,2,45
Pristipomoides multidens,16507,13,22,2,37
Mesocottus haitej,16527,13,22,2,37
Cirrhinus molitorella,16602,13,22,2,37
Acrossocheilus hemispinus,16590,13,22,2,37
Acrossocheilus barbodon,16596,13,22,2,37
Agrotis ipsilon,15377,13,22,2,37
Pseudogobius javanicus,16493,13,22,2,37
Saurogobio dumerili,16601,13,22,2,37
Biwia springeri,16606,13,22,2,37
Gnathopogon strigatus,16602,13,22,2,37
Squalidus wolterstorffi,16602,13,22,2,37
Microphysogobio longidorsalis,16603,13,22,2,37
Hemibarbus umbrifer,16611,13,22,2,37
Galeocerdo cuvier,16703,13,22,2,37
Anas poecilorhyncha,16608,13,22,2,37
Micronycteris megalotis,16589,13,22,2,37
Anoura caudifer,16546,13,22,2,37
Brachyphylla cavernarum,16785,13,22,2,37
Carollia perspicillata,16711,13,22,2,37
Desmodus rotundus,16659,13,22,2,37
Lophostoma silvicolum,16666,13,22,2,37
Pteronotus rubiginosus,16616,13,22,2,37
Rhinophylla pumilio,16671,13,22,2,37
Sturnira tildae,16637,13,22,2,37
Vampyrum spectrum,16637,13,22,2,37
Sibynophis chinensis,17163,13,22,2,37
Candida bohioensis,69218,19,24,2,45
Pleuronichthys cornutus,17469,13,22,2,37
Eusthenes cupreus,16229,13,22,2,37
Hymeniacidon sinapium,23435,14,25,2,41
Anas crecca,16601,13,22,2,37
Acipenser ruthenus,16790,13,22,2,37
Metzia formosae,16614,13,22,2,37
Johnius belangerii,19154,13,22,2,37
Spinibarbus sinensis,16591,13,22,2,37
Sepia apama,16184,13,22,2,37
Sepia latimanus,16225,13,22,2,37
Sepia lycidas,16244,13,22,2,37
Bolocera tuediae,19143,14,2,2,18
Luciola cruciata,15989,13,22,2,37
Sarcocheilichthys sinensis,16684,13,22,2,37
Ephestia kuehniella,15295,13,22,2,37
Kurtus gulliveri,16661,13,22,2,37
Istiophorus albicans,16514,13,22,2,37
Trichogaster lalius,16476,13,22,2,37
Parachanna insignis,16607,13,22,2,37
Platycephalus indicus,16542,13,22,2,37
Dysalotus alcocki,16460,13,22,2,37
Champsodon cf. snyderi CBM-ZF 10876,18903,13,22,2,37
Sphyraena barracuda,16707,13,22,2,37
Eumegistus illustris,16711,13,22,2,37
Taractes asper,16720,13,22,2,37
Pteraclis aesticola,16809,13,22,2,37
Kali indica,16627,13,22,2,37
Sphyraena japonica,16760,13,22,2,37
Nesiarchus nasutus,16703,13,22,2,37
Promethichthys prometheus,16810,13,22,2,37
Thyrsitoides marleyi,16138,13,22,2,37
Ruvettus pretiosus,16202,13,22,2,37
Assurger anzac,16510,13,22,2,37
Evoxymetopon poeyi,16475,13,22,2,37
Gymnosarda unicolor,16510,13,22,2,37
Ariomma lurida,16526,13,22,2,37
Ariomma indicum,16537,13,22,2,37
Tetragonurus cuvieri,16485,13,22,2,37
Tetragonurus atlanticus,16476,13,22,2,37
Pampus punctatissimus,16553,13,22,2,37
Peprilus triacanthus,16519,13,22,2,37
Rexea nakamurai,16382,13,22,2,37
Epinnula magistralis,16545,13,22,2,37
Aphanopus carbo,16406,13,22,2,37
Pomatomus saltatrix,16544,13,22,2,37
Echeneis naucrates,16612,13,22,2,37
Epinephelus merra,17017,13,22,2,37
Apogon semilineatus,16508,13,22,2,37
Pterapogon kauderni,16530,13,22,2,37
Paracirrhites arcatus,17336,13,22,2,37
Sasakia funebris,15233,13,22,2,37
Tonatia saurophila,16629,13,22,2,37
Entransia fimbriata,61645,35,30,3,68
Roya obtusa,69465,41,26,3,70
Acheilognathus yamatsutae,16703,13,22,2,37
Cottus hangiongensis,16598,13,22,2,37
Ganoderma sinense,86451,48,28,2,78
Monomastix sp. OKE-1,60883,58,26,3,87
Microspora stagnorum,87405,47,28,3,78
Batocera lineolata,15418,13,22,2,37
Spodoptera litura,15388,13,22,2,37
Sphyrna lewini,16726,13,22,2,37
Hylobitelus xiaoi,16123,13,22,2,37
Cavariella salicicola,16317,13,22,2,37
Arborophila brunneopectus,16719,13,22,2,37
Eurema hecabe,15160,13,22,2,37
Rhodeus shitaiensis,16774,13,22,2,37
Junonia orithya,15214,13,22,2,37
Myotis ikonnikovi,16584,13,22,2,37
Glyphodes quadrimaculalis,15255,13,22,2,37
Dopasia harti,17163,13,22,2,37
Microphysogobio brevirostris,16608,13,22,2,37
Pseudobagrus trilineatus,16535,13,22,2,37
Odontobutis potamophila,16932,13,22,2,37
Trachinotus ovatus,16563,13,22,2,37
Jellisonia amadoi,17031,13,22,2,37
Plagiognathops microlepis,16623,13,22,2,37
Misgurnus mohoity,16566,13,22,2,37
Channa marulius,16569,13,22,2,37
Notochthamalus scabrosus,15397,13,21,2,36
Cordyceps militaris,33277,15,26,2,43
Rhinogobius similis,16520,13,22,2,37
Sepiella inermis,16191,13,22,2,37
Myotis macrodactylus,17562,13,22,2,37
Protobothrops cornutus,17219,13,22,2,37
Lithobates catesbeianus,18241,13,22,2,37
Solenaia oleivora,16392,13,22,2,37
Tor sinensis,16579,13,22,2,37
Takydromus sexlineatus,18943,13,22,2,37
Cobitis lutheri,16639,13,22,2,37
Oxygymnocypris stewartii,16646,13,22,2,37
Phrynocephalus przewalskii,16892,13,23,2,38
Rhinogobio ventralis,16607,13,22,2,37
Rhodeus sinensis,16677,13,22,2,37
Hippocampus erectus,16529,13,22,2,37
Silurus soldatovi,16527,13,22,2,37
Hasemania nana,16581,13,22,2,37
Pseudobagrus ondon,16534,13,22,2,37
Pseudobagrus albomarginatus,16533,13,22,2,37
Chlamydoselachus anguineus,17314,13,22,2,37
Notorynchus cepedianus,16990,13,22,2,37
Hexanchus griseus,17223,13,22,2,37
Hexanchus nakamurai,18605,13,22,2,37
Somniosus pacificus,16730,13,22,2,37
Pseudotriakis microdon,16700,13,22,2,37
Pleurocorallium elatius,18969,14,1,2,17
Tursiops australis,16388,13,22,2,37
Dendronephthya suensoni,18851,14,1,2,17
Pyrgilauda ruficollis,16909,13,22,2,37
Oncocephalus breviscutum,15948,13,22,2,37
Odontobutis sinensis,17441,13,22,2,37
Prionace glauca,16705,13,22,2,37
Trimeresurus albolabris,17220,13,22,2,37
Pristis clavata,16804,13,22,2,37
Alopias pelagicus,16692,13,22,2,37
Acropora humilis,18479,13,2,2,17
Acropora muricata,18481,13,2,2,17
Acropora horrida,18480,13,2,2,17
Acropora hyacinthus,18566,13,2,2,17
Acropora aspera,18479,13,2,2,17
Acropora florida,18365,13,2,2,17
Acropora yongei,18342,13,2,2,17
Acropora digitifera,18479,13,2,2,17
Acropora nasuta,18481,13,2,2,17
Acropora divaricata,18481,13,2,2,17
Acropora robusta,18480,13,2,2,17
Scleropages jardinii,16670,13,22,2,37
Aetobatus flagellum,20201,13,22,2,37
Sicyopterus lagocephalus,16500,13,22,2,37
Nucifraga columbiana,16905,13,22,2,37
Campylorhynchus zonatus,16780,13,22,2,37
Rhinobatos hynnicephalus,16776,13,22,2,37
Panthera onca,17049,13,22,2,37
Dinocras cephalotes,15666,13,22,2,37
Salvelinus leucomaenis,16658,13,22,2,37
Saurogobio dabryi,16604,13,22,2,37
Laternula elliptica,14622,13,22,2,37
Epinephelus bleekeri,17227,13,26,2,41
Pristaulacus compressus,15563,13,22,2,37
Leptobotia rubrilabris,16585,13,22,2,37
Pseudobrama simoni,16618,13,22,2,37
Celaenorrhinus maculosa,15282,13,22,2,37
Misgurnus bipartitus,16636,13,22,2,37
Aspiorhynchus laticeps,16591,13,22,2,37
Pethia conchonius,17082,13,22,2,37
Barbatula nuda,16619,13,22,2,37
Corallium rubrum,18915,14,1,2,17
Schizopyge niger,16585,13,22,2,37
Schizothorax esocinus,16583,13,22,2,37
Onychostoma rara,16590,13,22,2,37
Pallisentis celatus,13855,12,22,2,36
Corythucha ciliata,15257,13,22,2,37
Meretrix lyrata,21625,13,26,2,41
Thymallus grubii,16662,13,22,2,37
Hemiculter leucisculus,16617,13,22,2,37
Gobiobotia intermedia,16608,13,22,2,37
Caranx ignobilis,16588,13,22,2,37
Sarcocheilichthys lacustris,16683,13,22,2,37
Cherax quadricarinatus,15869,13,22,2,37
Cherax glaber,15806,13,22,2,37
Monotrete leiurus,16448,13,22,2,37
Garra rufa,16763,13,22,2,37
Labeo chrysophekadion,16602,13,22,2,37
Labeo pierrei,16766,13,22,2,37
Garra spilota,16822,13,22,2,37
Labeo angra,16606,13,22,2,37
Osteochilus nashii,16605,13,22,2,37
Labiobarbus ocellatus,16596,13,22,2,37
Schismatorhynchos nukta,16606,13,22,2,37
Labeo cyclorhynchus,16610,13,22,2,37
Henicorhynchus lineatus,16825,13,22,2,37
Osteochilus schlegelii,16575,13,22,2,37
Thynnichthys polylepis,16599,13,22,2,37
Garra flavatra,16743,13,22,2,37
Labiobarbus leptocheilus,16593,13,22,2,37
Labiobarbus lineatus,16598,13,22,2,37
Labeo lineatus,16606,13,22,2,37
Sepia aculeata,16219,13,22,2,37
Beauveria pseudobassiana,28006,15,25,3,43
Annulohypoxylon stygium,133782,56,26,2,84
Salvia miltiorrhiza,499236,138,22,5,165
Metagonimus yokogawai,15258,12,23,2,37
Acremonium chrysogenum,27266,17,26,2,45
Bursaphelenchus xylophilus,14778,12,22,2,36
Babylonia areolata,15445,13,22,2,37
Lycaena phlaeas,15280,13,22,2,37
Curetis bulis,15162,13,22,2,37
Petaurista hainana,16502,13,22,2,37
Paramphistomum cervi,14014,12,22,2,36
Hypodontus macropi,13634,12,22,2,36
Macropicola ocydromi,13659,12,22,2,36
Acheilognathus chankaensis,16774,13,22,2,37
Zacco platypus,16611,13,22,2,37
Mystacoleucus marginatus,16611,13,22,2,37
Potamotrygon motoro,17448,13,22,2,37
Mythimna separata,15332,13,22,2,37
Pteropus alecto,16739,13,22,2,37
Marphysa sanguinea,15159,13,22,2,37
Pleurogrammus azonus,16591,13,22,2,37
Mustela kathiah,16552,13,22,2,37
Saimiri oerstedii citrinellus,16472,13,22,2,37
Carposina sasakii,15611,13,22,2,37
Leptobelus gazella,16007,13,22,2,37
Cyclemys tcheponensis,16593,13,22,2,37
Hemibagrus spilopterus,16521,13,22,2,37
Cynoglossus sinicus,16478,13,22,2,37
Zebrias quagga,17045,13,22,2,37
Cynoglossus bilineatus,16454,13,22,2,37
Paraplagusia bilineata,16985,13,22,2,37
Paraplagusia blochii,16611,13,22,2,37
Cynoglossus puncticeps,17142,13,22,2,37
Cyclocheilichthys enoplos,16579,13,22,2,37
Epiophlebia superstes,15435,13,22,2,37
Uropsilus soricipes,16575,13,22,2,37
Solenaia carinata,16716,14,22,2,38
Ophiacantha linea,15845,13,22,2,37
Nacospatangus altus,15763,13,22,2,37
Cistopus taiwanicus,15793,13,22,2,37
Protostrongylus rufescens,13619,12,22,2,36
Meriones unguiculatus,16351,13,22,2,37
Sebastes koreanus,16499,13,22,2,37
Cetorhinus maximus,16670,13,22,2,37
Plesiomyzon baotingensis,16541,13,22,2,37
Esox reichertii,16909,13,22,2,37
Polypterus palmas buettikoferi,16624,13,22,2,37
Mus musculus domesticus,16300,13,22,2,37
Vestalis melania,16685,13,22,2,37
Argynnis hyperbius,15156,13,22,2,37
Apatura ilia,15242,13,22,2,37
Liriomyza bryoniae,16183,13,22,2,37
Liriomyza huidobrensis,16236,13,22,2,37
Taeniura meyeni,17638,13,22,2,37
Coilia mystus,17143,13,22,2,37
Liobagrus kingi,16483,13,22,2,37
Luciobarbus capito,16603,13,22,2,37
Tachysurus ussuriensis,16536,13,22,2,37
Oxyurichthys formosanus,16584,13,22,2,37
Acentrogobius chlorostigmatoides,17098,13,22,2,37
Dolycoris baccarum,16549,13,22,2,37
Ammodytes hexapterus,16527,13,22,2,37
Sarcocheilichthys nigripinnis,16680,13,22,2,37
Carcharhinus obscurus,16706,13,22,2,37
Mystus rhegma,16525,13,22,2,37
Ctenomys leucodon,16216,13,22,2,37
Mesocentrotus nudus,15709,13,22,2,37
Cupido argiades,15330,13,22,2,37
Sphinx morio,15299,13,22,2,37
Schizothorax oconnori,16590,13,22,2,37
Epinephelus fasciatomaculosus,16682,13,22,2,37
Undaria pinnatifida,37402,38,24,3,65
Epinephelus latifasciatus,16389,13,22,2,37
Epinephelus areolatus,16893,13,22,2,37
Chaeturichthys stigmatias,18562,13,22,2,37
Hippocampus trimaculatus,16535,13,22,2,37
Liobagrus marginatoides,16498,13,22,2,37
Hebomoia glaucippe,15701,13,22,2,37
Johnius grypotus,18523,13,22,2,37
Hydatigera parva,13482,12,22,2,36
Hydatigera krepkogorski,13792,12,22,2,36
Prasinoderma coloniale,54546,34,36,4,74
Vaccinium macrocarpon,459678,33,18,3,54
Versteria mustelae,13582,12,22,2,36
Liriodendron tulipifera,553721,42,21,3,66
Chikila fulleri,16198,13,22,2,37
Melanitis leda,15122,13,22,2,37
Paraplagusia japonica,16694,13,22,2,37
Lamprotula tortuosa,15722,13,22,2,37
Protobothrops mucrosquamatus,17234,13,22,2,37
Ancherythroculter nigrocauda,16623,13,22,2,37
Amata formosae,15463,13,22,2,37
Sogatella furcifera,16612,13,22,2,37
Anodontostoma chacunda,16772,13,22,2,37
Proechimys longicaudatus,16816,13,22,2,37
Heptranchias perlo,18909,13,22,2,37
Epinephelus sexfasciatus,16786,13,22,2,37
Garra orientalis,17288,13,22,2,37
Novumbra hubbsi,16567,13,22,2,37
Zebrias zebra,16758,13,22,2,37
Umbra pygmaea,16513,13,22,2,37
Octostigma sinensis,15122,13,22,2,37
Parajapyx emeryanus,15268,13,22,2,37
Occasjapyx japonicus,15746,13,22,2,37
Lepidocampa weberi,14360,13,0,0,13
Diuraphis noxia,15784,13,22,2,37
Polytomella magna,24370,7,2,24,33
Botrylloides nigrum,14427,13,24,2,39
Aplysina cauliformis,19620,14,25,2,41
Rhipicephalus microplus,14905,13,22,2,37
Squalidus argentatus,16607,13,22,2,37
Necturus beyeri,16284,13,22,2,37
Proteus anguinus,16584,13,22,2,37
Scleronephthya gracillimum,18950,14,1,2,17
Lamprotula leaii,16530,13,22,2,37
Rattus niobe,16298,13,22,2,37
Rhipicephalus australis,14891,13,22,2,37
Rhipicephalus geigyi,14948,13,22,2,37
Mugilogobius abei,16483,13,22,2,37
Glyphis garricki,16702,13,22,2,37
Rapisma xizangense,15961,13,22,2,37
Rapisma zayuanum,15984,13,22,2,37
Semisulcospira libertina,15432,13,22,2,37
Schizothorax labiatus,16582,13,22,2,37
Schizothorax progastus,16575,13,22,2,37
Pteronotus parnellii,16564,13,22,2,37
Argas lagenoplastis,14478,13,22,2,37
Otobius megnini,14430,13,22,2,37
Argas miniatus,14416,13,22,2,37
Ornithodoros rostratus,14452,13,22,2,37
Ornithodoros brasiliensis,14489,13,22,2,37
Eubasilissa regina,15021,13,22,2,37
Acrossocheilus fasciatus,16589,13,22,2,37
Hemisus marmoratus,20093,13,22,2,37
Trichobatrachus robustus,21418,13,22,2,37
Neochauliodes bowringi,16064,13,22,2,37
Cynoglossus itinus,16915,13,22,2,37
Colistium nudipinnis,16588,13,22,2,37
Peltorhamphus novaezeelandiae,16889,13,22,2,37
Cryptocellus narino,14554,13,22,2,37
Pseudocellus gertschi,14477,13,22,2,37
Ricinoides karschii,14614,13,22,2,37
Sebastes inermis,16504,13,22,2,37
Capricornis milneedwardsii,16444,13,22,2,37
Decapterus macrosoma,16545,13,22,2,37
Vulpes zerda,16683,13,22,2,37
Heterotilapia buettikoferi,16577,13,22,2,37
Paracymoriza distinctalis,15354,13,22,2,37
Sinocyclocheilus anophthalmus,16574,13,22,2,37
Conus consors,16112,13,22,2,37
Microphysogobio tafangensis,16605,13,22,2,37
Acanthacorydalis orientalis,15753,13,22,2,37
Pampus argenteus,17098,13,23,2,38
Orinhippus tibetanus,15611,13,22,2,37
Boleophthalmus boddarti,16727,13,22,2,37
Ranina ranina,15557,13,22,2,37
Pleurogrammus monopterygius,16575,13,22,2,37
Cherax robustus,15703,13,22,2,37
Cherax quinquecarinatus,15810,13,22,2,37
Cherax dispar,15675,13,22,2,37
Cherax cairnsensis,15600,13,22,2,37
Cherax preissii,15809,13,22,2,37
Tenualosa ilisha,16821,13,22,2,37
Microthrissa congica,16735,13,22,2,37
Clupeichthys aesarnensis,16729,13,22,2,37
Clupeoides sp. Chao Phraya,16639,13,22,2,37
Mauremys japonica,16443,13,22,2,37
Tegula brunnea,17690,13,22,2,37
Periplaneta americana,15584,13,22,2,37
Echinotriton andersoni,16268,13,22,2,37
Tylototriton verrucosus,17100,13,23,2,38
Amoya chusanensis,16486,13,22,2,37
Leptobrachella oshanensis,17747,13,22,2,37
Dendronephthya castanea,18907,14,1,2,17
Costaria costata,37461,38,25,3,66
Strongylocentrotus intermedius,15700,13,22,2,37
Pseudocentrotus depressus,15729,13,22,2,37
Heliocidaris crassispina,15702,13,22,2,37
Aleuroglyphus ovatus,14328,13,22,2,37
Lophura swinhoii,16693,13,22,2,37
Ratufa bicolor,16563,13,22,2,37
Abbottina rivularis,16597,13,22,2,37
Parazacco spilurus,16612,13,22,2,37
Hynobius maoershanensis,16412,13,22,2,37
Megaselia scalaris,15599,13,22,2,37
Macaca assamensis,16542,13,22,2,37
Adelphocoris fasciaticollis,15434,13,22,2,37
Metzia mesembrinum,16611,13,22,2,37
Onychostoma macrolepis,16595,13,22,2,37
Paramisgurnus dabryanus,16570,13,22,2,37
Thamnaconus tessellatus,16437,13,22,2,37
Lamprotula gottschei,15915,13,22,2,37
Gracilaria salicornia,25272,25,20,2,47
Hypsibius dujardini,15169,13,23,2,38
Mauremys annamensis,16844,13,22,2,37
Rhodeus suigensis,16733,13,22,2,37
Pseudopungtungia tenuicorpus,16590,13,22,2,37
Gobiobotia macrocephala,16610,13,22,2,37
Podoces hendersoni,16867,13,22,2,37
Microphysogobio koreensis,16606,13,22,2,37
Acheilognathus somjinensis,16569,13,22,2,37
Cyprinus carpio wuyuanensis x Carassius auratus,16580,13,22,2,37
Pseudolaubuca engraulis,16612,13,22,2,37
Hemitrygon akajei,17658,13,22,2,37
Hydra sinensis,16189,13,2,2,17
Gymnocypris dobula,16720,13,22,2,37
Gymnocypris namensis,16674,13,22,2,37
Schizopygopsis thermalis,16676,13,22,2,37
Amphiascoides atopus,13831,13,22,2,37
Lepomis cyanellus,16485,13,22,2,37
Synodus variegatus,16448,13,22,2,37
Opistognathus jacksoniensis,16550,13,22,2,37
Acomys cahirinus,16217,13,22,2,37
Acheilognathus macropterus,16774,13,22,2,37
Chrysemys picta bellii,16875,13,22,2,37
Orcinus orca,16386,13,22,2,37
Pseudorhombus cinnamoneus,16599,13,22,2,37
Tapirus indicus,16717,13,22,2,37
Alepes kleinii,16571,13,22,2,37
Urogymnus granulatus,17657,13,22,2,37
Vieja melanura,16543,13,22,2,37
Mustelus griseus,16754,13,22,2,37
Rana dybowskii,18864,13,22,2,37
Thitarodes pui,15064,13,22,2,37
Tsukubamonas globosa,48463,52,26,3,81
Anser cygnoides,16739,13,22,2,37
Huso dauricus,16691,13,22,2,37
Toxascaris leonina,14310,12,22,2,36
Caecilia tentaculata,16297,13,22,2,37
Caecilia gracilis,16209,13,22,2,37
Chthonerpeton indistinctum,17215,13,22,2,37
Grandisonia sechellensis,16094,13,22,2,37
Ichthyophis bombayensis,16100,13,22,2,37
Indotyphlus maharashtraensis,16167,13,22,2,37
Luetkenotyphlus brasiliensis,16271,13,22,2,37
Microcaecilia dermatophaga,16085,13,22,2,37
Microcaecilia unicolor,16007,13,22,2,37
Potomotyphlus kaupii,17035,13,22,2,37
Praslinia cooperi,16192,13,22,2,37
Schistometopum gregorii,16038,13,22,2,37
Uraeotyphlus gansi,16101,13,22,2,37
Carcharias taurus,16773,13,22,2,37
Carcharhinus sorrah,16707,13,22,2,37
Carcharhinus leucas,16704,13,22,2,37
Iwatanemertes piperata,16382,13,22,2,37
Rana cf. chensinensis QYCRCCH_C,18808,13,22,2,37
Schizothorax plagiostomus,16576,13,22,2,37
Sarcophaga peregrina,14922,13,22,2,37
Megalobrama amblycephala x Parabramis pekinensis,16623,13,22,2,37
Humphaplotropis culaishanensis (nomen nudum),15659,13,22,2,37
Coilia grayii,16851,13,22,2,37
Liachirus melanospilos,17001,13,22,2,37
Sus cebifrons,16473,13,22,2,37
Nematalosa nasus,16674,13,22,2,37
Drosophila santomea,16022,13,22,2,37
Amphiprion polymnus,16804,13,22,2,37
Amphilophus citrinellus,16522,13,22,2,37
Schizothorax prenanti,16587,13,22,2,37
Mesoplodon grayi,16347,13,22,2,37
Cairina moschata,16610,13,22,2,37
Nerthra indica,16079,13,22,2,37
Hydrometra greeni,15416,13,22,2,37
Myotis formosus,17159,13,22,2,37
Ichthyaetus relictus,16586,13,22,2,37
Phoxinus ujmonensis,17738,13,22,2,37
Lophius litulon,16431,13,22,2,37
Polymastia littoralis,21719,14,25,2,41
Cervus nippon kopschi,16429,13,22,2,37
Chiloscyllium punctatum,16703,13,22,2,37
Scoliodon macrorhynchos,16693,13,22,2,37
Cryptococcus neoformans var. grubii H99,24919,13,14,0,27
Magnusiomyces magnusii,42757,31,25,2,58
Epinephelus stictus,16524,13,22,2,37
Chanodichthys dabryi,16622,13,22,2,37
Erynnis montanus,15530,13,22,2,37
Nematalosa come,16644,13,22,2,37
Hippocampus histrix,16523,13,22,2,37
Micropercops swinhonis,16493,13,22,2,37
Quasipaa boulengeri,17741,13,23,2,38
Thraustotheca clavata,47382,41,30,4,75
Haplorchis taichui,15130,12,22,2,36
Spheniscus demersus,17346,13,22,2,37
Engaeus lengana,15934,13,22,2,37
Liobagrus marginatus,16497,13,22,2,37
Cherax monticola,15917,13,22,2,37
Pacris xizangensis,15622,13,22,2,37
Kingdonella bicollina,15630,13,22,2,37
Mekongiella kingdoni,15932,13,22,2,37
Petaurista alborufus,16507,13,22,2,37
Clarias batrachus,16511,13,22,2,37
Pangasius pangasius,16476,13,22,2,37
Poecilobdella manillensis,14470,13,22,2,37
Whitmania laevis,14433,13,22,2,37
Erpobdella octoculata,14407,13,22,2,37
Whitmania acranulata,14462,13,22,2,37
Massicus raddei,15858,13,22,2,37
Luehdorfia taibai,15553,13,22,2,37
Tetraogallus tibetanus,16692,13,22,2,37
Perdix hodgsoniae,16699,13,22,2,37
Clarias fuscus,16518,13,22,2,37
Margaritifera dahurica,16112,14,22,2,38
Perinereis aibuhitensis,15852,13,22,2,37
Dipturus chilensis,16909,13,22,2,37
Nobia grandis,15032,13,22,2,37
Ciconia nigra,17795,13,22,2,37
Cobitis elongatoides,16541,13,22,2,37
Carcharhinus amblyrhynchoides,16705,13,22,2,37
Amolops ricketti,17772,13,23,2,38
Blarinella quadraticauda,17014,13,22,2,37
Rhinobatos schlegelii,16780,13,22,2,37
Rexea solandri,16350,13,22,2,37
Selar crumenophthalmus,16610,13,22,2,37
Lanceolaria lanceolata,15782,13,22,2,37
Vulpes corsac,16721,13,22,2,37
Niviventer confucianus,16281,13,22,2,37
Cercopithecus mitis,16512,13,22,2,37
Allochrocebus lhoesti,16518,13,22,2,37
Cercopithecus diana,16505,13,22,2,37
Cercocebus torquatus,16542,13,22,2,37
Allenopithecus nigroviridis,16517,13,22,2,37
Amphiprion percula,16645,13,22,2,37
Amphiprion clarkii,16976,13,22,2,37
Carangoides malabaricus,16561,13,22,2,37
Aix galericulata,16605,13,22,2,37
Trachypithecus francoisi,16554,13,22,2,37
Trachypithecus cristatus,16557,13,22,2,37
Nemipterus japonicus,16995,13,22,2,37
Pseudaesopia japonica,16789,13,22,2,37
Pardachirus pavoninus,16537,13,22,2,37
Belligobio nummifer,16610,13,22,2,37
Hemibagrus guttatus,16528,13,22,2,37
Mastacembelus armatus,16486,13,22,2,37
Schizopyge dolichonema,16583,13,22,2,37
Saurida microlepis,16510,13,22,2,37
Egretta garzetta,17361,13,22,2,37
Amaurornis akool,16950,13,22,2,37
Rhigonema thysanophora,15015,12,22,2,36
Fasciola gigantica,14478,12,22,2,36
Trachinotus blochii,16558,13,22,2,37
Leptomantella albella,15534,13,22,2,37
Cherax crassimanus,15807,13,22,2,37
Equus przewalskii,16592,13,22,2,37
Salmo trutta,16677,13,22,2,37
Epinephelus tukula,16503,13,22,2,37
Pampus chinensis,16535,13,22,2,37
Cheirotonus jansoni,17249,13,22,2,37
Jaminaea angkorensis,29999,18,22,2,42
Pampus echinogaster,17694,13,23,2,38
Polyplectron germaini,16699,13,22,2,37
Mareca falcata,16601,13,22,2,37
Rhynchosporium agropyri,68904,47,29,2,78
Rhynchobrunnera orthospora,49539,27,29,2,58
Rhynchosporium secalis,68729,47,30,2,79
Macquaria australasica,16496,13,22,2,37
Lutraria rhynchaena,16927,12,22,2,36
Rhincodon typus,16875,13,22,2,37
Henosepilachna pusillanima,16216,13,22,2,37
Cobitis melanoleuca granoei,16636,13,22,2,37
Dipturus kwangtungensis,16912,13,22,2,37
Rhizoctonia solani,235849,127,26,2,155
Ascalohybris subjacens,15873,13,22,2,37
Trionyx triunguis,16590,13,22,2,37
Equus zebra hartmannae,16409,13,22,2,37
Equus hemionus kulan,16381,13,22,2,37
Equus ovodovi,16415,13,22,2,37
Magnusiomyces ingens,37684,22,25,2,49
Magnusiomyces tetraspermus,44469,30,25,2,57
Magnusiomyces capitatus,43486,24,25,2,51
Cecropis daurica,17949,13,22,2,37
Equus burchellii chapmani,16407,13,22,2,37
Lumbricus terrestris,14998,13,22,2,37
Cherax cainii,15801,13,22,2,37
Rhynchosporium commune,69581,46,29,2,77
Engaeus lyelli,16027,13,22,2,37
Squalus acanthias,16738,13,22,2,37
Poecilia reticulata,16538,13,22,2,37
Fringilla montifringilla,16807,13,22,2,37
Tarsius lariang,16965,13,22,2,37
Tarsius dentatus,16965,13,22,2,37
Tarsius wallacei,16957,13,22,2,37
Carcharhinus acronotus,16719,13,22,2,37
Bemisia afer,14968,13,22,2,37
Mogurnda adspersa,16523,13,22,2,37
Jacana spinosa,17079,13,22,2,37
Jacana jacana,16975,13,22,2,37
Siganus puellus,16504,13,22,2,37
Aquila chrysaetos,17332,13,22,2,37
Siganus guttatus,16505,13,22,2,37
Graphium mullah,15226,13,22,2,37
Maruca vitrata,15385,13,22,2,37
Cephalopholis sexmaculata,16589,13,22,2,37
Isurus paucus,16704,13,22,2,37
Gymnura poecilura,17874,13,22,2,37
Botrylloides leachii,14408,13,24,2,39
Grammistes sexlineatus,16502,13,22,2,37
Protosalanx hyalocranius,16693,13,22,2,37
Folsomotoma octooculata,15338,13,22,2,37
Mesocentrotus franciscanus,15649,13,22,2,37
Amolops mantzorum,17744,13,22,2,37
Junceella fragilis,18724,14,1,2,17
Trachinotus carolinus,16544,13,22,2,37
Draconetta xenica,16617,13,22,2,37
Solenostomus paradoxus,16425,13,22,2,37
Doryrhamphus japonicus,16568,13,22,2,37
Mulloidichthys vanicolensis,16563,13,22,2,37
Dactyloptena orientalis,16702,13,22,2,37
Fistularia petimba,16465,13,22,2,37
Phycodurus eques,16520,13,22,2,37
Parupeneus multifasciatus,16607,13,22,2,37
Neosynchiropus moyeri,16837,13,22,2,37
Callionymus enneactis,17171,13,22,2,37
Synchiropus splendidus,16430,13,22,2,37
Hoplolatilus cuniculus,16853,13,27,2,42
Takifugu flavidus,16449,13,22,2,37
Lithodes nintokuae,15731,13,21,2,36
Hypsiglena unaocularus,17211,13,22,2,37
Chrysocyon brachyurus,16760,13,22,2,37
Sypharochiton sinclairi,15028,13,22,2,37
Sypharochiton pelliserpentis,15048,13,22,2,37
Atractosteus tropicus,16280,13,22,2,37
Porites panamensis,18628,13,1,2,16
Pythonichthys microphthalmus,17042,13,22,2,37
Moringua microchir,15858,13,22,2,37
Simenchelys parasitica,16689,13,22,2,37
Coloconger cadenati,17755,13,22,2,37
Kaupichthys hyoproroides,16662,13,22,2,37
Nessorhamphus ingolfianus,17782,13,22,2,37
Cyema atrum,16868,13,21,2,36
Rhinomuraena quaesita,16566,13,22,2,37
Derichthys serpentinus,17077,13,22,2,37
Anarchias sp. Ansp,16497,13,22,2,37
Muraenesox bagio,18247,13,22,2,37
Leptocephalus sp. 'type II larva' (Smith_ 1989),18037,13,23,2,38
Culter alburnus,16622,13,22,2,37
Congriscus sp. Tht2,17617,13,22,2,37
Kappaphycus striatus,25242,24,24,2,50
Nemichthys scolopaceus,17457,13,22,2,37
Marmota himalayana,16443,13,22,2,37
Repomucenus curvicornis,16406,13,22,2,37
Carcinoscorpius rotundicauda,15033,13,22,2,37
Sirthenea flavipes,15961,13,22,2,37
Phlebia radiata,156348,126,28,2,156
Attacus atlas,15282,13,22,2,37
Ficedula albicollis,16787,13,22,2,37
Brachyrhynchus hsiaoi,15250,13,22,2,37
Nesidiocoris tenuis,17544,13,22,2,37
Fusarium circinatum,67109,30,27,2,59
Diabrotica barberi,16366,13,22,2,37
Apolygus lucorum,14768,13,22,2,37
Lepus timidus,17755,13,22,2,37
Lepus townsendii,17732,13,22,2,37
Lepus granatensis,16916,13,22,2,37
Lepus americanus,17042,13,22,2,37
Pyropia fucicola,35035,31,23,2,56
Pyropia kanakaensis,39300,30,25,2,57
Pristiophorus japonicus,18430,13,22,2,37
Eremothecium gossypii FDAG1,23497,8,23,2,33
Aspergillus nidulans FGSC A4,33227,20,28,2,50
Rhazya stricta,548608,46,20,3,69
Batis maritima,403930,112,20,3,135
Pericrocotus ethologus,16935,13,22,2,37
Lepus coreanus,17472,13,22,2,37
Samariscus latus,18706,13,24,2,39
Peirates arcuatus,16176,13,22,2,37
Lamna ditropis,16699,13,22,2,37
Nanorana taihangnica,17412,13,22,2,37
Barbonymus schwanefeldii,16576,13,22,2,37
Squatina japonica,16689,13,22,2,37
Chanodichthys recurviceps,16622,13,22,2,37
Hemibagrus wyckioides,16525,13,22,2,37
Pseudobagrus emarginatus,16534,13,22,2,37
Ceryle rudis,17355,13,22,2,37
Argiope bruennichi,14063,13,21,2,36
Maruca testulalis,15110,13,22,2,37
Carcharhinus melanopterus,16706,13,22,2,37
Aseraggodes kobensis,16944,13,22,2,37
Telamonia vlijmi,14601,13,22,2,37
Ptychidio jordani,16602,13,22,2,37
Gramastacus lacus,15764,13,22,2,37
Athyma selenophora,15200,13,22,2,37
Athyma kasa,15230,13,22,2,37
Athyma cama,15269,13,22,2,37
Euthalia irrubescens,15365,13,22,2,37
Athyma perius,15277,13,22,2,37
Athyma sinope,15257,13,22,2,37
Lexias dirtea,15250,13,22,2,37
Dophla evelina,15320,13,22,2,37
Neptis soma,15130,13,22,2,37
Pantoporia hordonia,15603,13,22,2,37
Yoma sabina,15330,13,22,2,37
Abrota ganga,15356,13,22,2,37
Parasarpa dudu,15236,13,22,2,37
Melanitis phedima,15142,13,22,2,37
Junonia almana,15256,13,22,2,37
Polyura arja,15363,13,22,2,37
Dichorragia nesimachus,15355,13,22,2,37
Athyma asura,15181,13,22,2,37
Neope pulaha,15209,13,22,2,37
Parantica sita,15211,13,22,2,37
Bhagadatta austenia,15615,13,22,2,37
Euploea core,15192,13,22,2,37
Argynnis childreni,15131,13,22,2,37
Tanaecia julii,15316,13,22,2,37
Parthenos sylvia,15249,13,22,2,37
Athyma opalina,15240,13,22,2,37
Neptis philyra,15164,13,22,2,37
Ypthima akragas,15227,13,22,2,37
Megalobrama skolkovii,16620,13,22,2,37
Rhinogobio typus,16608,13,22,2,37
Napialus hunanensis,15301,13,22,2,37
Leptobrachium boringii,17085,13,23,2,38
Ideopsis similis,15200,13,22,2,37
Paracanthobrama guichenoti,16607,13,22,2,37
Siniperca roulei,16504,13,22,2,37
Siniperca undulata,16499,13,22,2,37
Pareuchiloglanis sinensis,16593,13,22,2,37
Ashtoret lunaris,15807,13,22,2,37
Gadopsis marmoratus,16407,13,22,2,37
Myomenippe fornasinii,15658,13,22,2,37
Thalamita crenata,15787,13,22,2,37
Triops australiensis,15125,13,22,2,37
Thenus orientalis,16826,13,23,2,38
Engaeus sericatus,17350,13,22,2,37
Engaeus quadrimanus,17321,13,22,2,37
Beauveria bassiana ARSEF 2860,2575,0,0,0,0
Beauveria bassiana ARSEF 2860,1283,0,0,0,0
Ilyoplax deschampsi,15460,13,22,2,37
Sargassum horneri,34606,37,25,3,65
Sargassum muticum,34720,37,25,3,65
Wildemania schizophylla,29156,26,23,2,51
Katharina tunicata,15532,13,22,2,37
Sargassum fusiforme,34696,37,25,3,65
Chlorella sorokiniana,52528,33,25,3,61
Bracteacoccus aerius,47158,17,24,6,47
Bracteacoccus minor,45175,21,24,6,51
Chlorotetraedron incus,38406,16,24,6,46
Chromochloris zofingiensis,44840,17,24,6,47
Mychonastes homosphaera,25149,13,23,6,42
Neochloris aquatica,38021,15,24,6,45
Ourococcus multisporus,49705,20,22,6,48
Pseudomuriella schumacherensis,43134,16,26,6,48
Crocodylus rhombifer,16795,13,22,2,37
Emberiza cioides,16765,13,22,2,37
Amphibalanus amphitrite,15683,13,22,2,37
Striatobalanus amaryllis,15064,13,22,2,37
Hemibarbus medius,16614,13,22,2,37
Leuciscus baicalensis,16606,13,22,2,37
Trachypithecus pileatus,16526,13,22,2,37
Hippocampus ingens,16526,13,22,2,37
Planiliza haematocheilus,16822,13,22,2,37
Danaus chrysippus,15236,13,22,2,37
Pavo cristatus,16686,13,22,2,37
Sinogastromyzon sichangensis,16567,13,22,2,37
Lista haraldusalis,15213,13,22,2,37
Hippocampus barbouri,16526,13,22,2,37
Ptychobarbus dipogon,16787,13,22,2,37
Myodes glareolus,16353,13,22,2,37
Sinosuthora webbiana,16960,13,22,2,37
Rhinogobio cylindricus,16610,13,22,2,37
Euprepiophis perlacea,17160,13,22,2,37
Microhyla pulchra,16744,13,22,2,37
Rana kunyuensis,22255,13,22,2,37
Sebastes oblongus,16396,13,22,2,37
Melanargia asiatica,15142,13,22,2,37
Triphysa phryne,15143,13,22,2,37
Turdus hortulorum,16759,13,22,2,37
Ianthocincla cineracea,17800,13,22,2,37
Lyrurus tetrix,16677,13,22,2,37
Decapterus maruadsi,16541,13,22,2,37
Aprasia parapulchella,16528,13,22,2,37
Vespertilio sinensis,16971,13,22,2,37
Lycodon rufozonatus,17188,13,22,2,37
Squalidus gracilis,16605,13,22,2,37
Haliotis laevigata,16545,13,22,2,37
Anourosorex squamipes,17121,13,22,2,37
Atrophaneura alcinous,15266,13,22,2,37
Tanakia lanceolata,16607,13,22,2,37
Nandinia binotata,17103,13,22,2,37
Genetta servalina,16938,13,22,2,37
Prionodon pardicolor,16718,13,22,2,37
Pteroplatytrygon violacea,17665,13,22,2,37
Apodemia mormo,15262,13,22,2,37
Lutjanus johnii,16596,13,22,2,37
Xenophysogobio boulengeri,16607,13,22,2,37
Ixobrychus flavicollis,17016,13,22,2,37
Plestiodon elegans,17304,13,22,2,37
Paratrioza sinica,14863,13,22,2,37
Discogobio tetrabarbatus,16596,13,22,2,37
Platax teira,16561,13,22,2,37
Aphis gossypii,15869,13,22,2,37
Salvelinus curilus,16654,13,22,2,37
Pomacea canaliculata,15707,13,22,2,37
Plectorhinchus cinctus,16523,13,22,2,37
Pseudogyrinocheilus prochilus,16595,13,22,2,37
Taenia regis,13489,12,22,2,36
Taenia arctos,13650,12,22,2,36
Taenia crocutae,13711,12,22,2,36
Cricetulus kamensis,16270,13,22,2,37
Amaurornis phoenicurus,17213,13,22,2,37
Tachybaptus ruficollis,16688,13,22,2,37
Aythya fuligula,16616,13,22,2,37
Carcharhinus plumbeus,16706,13,22,2,37
Triplophysa anterodorsalis,16567,13,22,2,37
Jinshaia sinensis,16567,13,22,2,37
Pavoraja nitida,16760,13,22,2,37
Tribolium audax,15925,13,22,2,37
Lissachatina fulica,15057,13,22,2,37
Aythya ferina,16616,13,22,2,37
Odorrana margaretae,17903,13,22,2,37
Suncus murinus,17240,13,22,2,37
Tirumala limniace,15285,13,22,2,37
Jinshaia abbreviata,16567,13,22,2,37
Corvus splendens,16926,13,22,2,37
Lepturichthys fimbriata,16567,13,22,2,37
Solea ovata,16782,13,22,2,37
Triplophysa siluroides,16574,13,22,2,37
Phrynocephalus putjatai,16283,13,22,2,37
Ptilopachus petrosus,16773,13,22,2,37
Crax daubentoni,16684,13,22,2,37
Crax rubra,16666,13,22,2,37
Caloperdix oculeus,16488,13,22,2,37
Colinus virginianus,16702,13,22,2,37
Schizothorax chongi,16584,13,22,2,37
Megalobrama amblycephala x Ancherythroculter nigrocauda,16621,13,22,2,37
Callimico goeldii,16523,13,22,2,37
Chiropotes israelita,16670,13,22,2,37
Cheracebus lugens,16689,13,22,2,37
Anas acuta,16599,13,22,2,37
Charybdis feriata,15660,13,22,2,37
Ladislavia taczanowskii,16613,13,22,2,37
Megabalanus ajax,15510,13,22,2,37
Sancassania berlesei,14273,13,22,2,37
Nematodirus spathiger,13519,12,22,2,36
Nematodirus oiratianus,13765,12,22,2,36
Culter alburnus x Ancherythroculter nigrocauda,16621,13,22,2,37
Carterocephalus silvicola,15765,13,22,2,37
Choaspes benjaminii,15300,13,22,2,37
Daimio tethys,15350,13,22,2,37
Lobocla bifasciata,15366,13,22,2,37
Potanthus flavus,15267,13,22,2,37
Paraglypturus tonganus (nomen nudum),15924,13,22,2,37
Monochamus alternatus,15874,13,22,2,37
Ridgeia piscesae,15002,13,22,2,37
Phrynocephalus versicolor,16429,13,23,2,38
Parafilaroides normani,13414,12,22,2,36
Dysmicohermes ingens,16271,13,22,2,37
Zootermopsis nevadensis,15444,13,22,2,37
Chelodina longicollis,16647,13,22,2,37
Tetrastemma olgarum,14580,13,22,2,37
Glyptothorax sinensis,16531,13,22,2,37
Henicorhina leucosticta,16727,13,22,2,37
Brachymystax tumensis,16836,13,22,2,37
Psoroptes ovis,14247,13,22,2,37
Mionectes oleagineus,17023,13,22,2,37
Sitobion avenae,15180,13,22,2,37
Phylloscopus inornatus,16875,13,22,2,37
Parnassius apollo,15404,13,22,2,37
Metzia longinasus,16614,13,22,2,37
Pycnonotus melanicterus,17011,13,22,2,37
Mytilus coruscus,16642,12,23,2,37
Paraneetroplus synspilus x Amphilophus citrinellus,16541,13,22,2,37
Cottus dzungaricus,16527,13,22,2,37
Anopheles cruzii,15449,13,22,2,37
Heliconius pachinus,15369,13,22,2,37
Papilio polytes,15256,13,22,2,37
Elaphe bimaculata,17183,13,22,2,37
Heliconius hecale,15338,13,22,2,37
Pterois miles,16497,13,22,2,37
Sylvirana guentheri,19053,13,22,2,37
Chanodichthys erythropterus,16629,13,22,2,37
Tadorna tadorna,16604,13,22,2,37
Anabas testudineus,16603,13,22,2,37
Macropodus ocellatus,16501,13,22,2,37
Paragyrodactylus variegatus,14517,12,22,2,36
Capsicum annuum,511530,193,25,3,221
Uropsilus sp. 1 FT-2014,16530,13,23,2,38
Papio anubis,16516,13,22,2,37
Carassius auratus ssp. 'Pingxiang',16576,13,22,2,37
Neopyropia yezoensis,41688,32,27,2,61
Phyllodactylus unctus,16881,13,22,2,37
Cephalopholis boenak,16771,13,22,2,37
Pseudobagrus brevicaudatus,16533,13,22,2,37
Pseudobagrus truncatus,16533,13,22,2,37
Hyattella sinuosa,16422,14,2,2,18
Megachasma pelagios,16694,13,22,2,37
Alopias superciliosus,16719,13,22,2,37
Emberiza spodocephala,16796,13,22,2,37
Schizothorax richardsonii,16592,13,22,2,37
Epinephelus quoyans,16797,13,22,2,37
Microphysogobio alticorpus,16568,13,22,2,37
Psenopsis anomala,16509,13,22,2,37
Epinephelus epistictus,16920,13,22,2,37
Onychostoma alticorpus,16607,13,22,2,37
Rhizomys pruinosus,16575,13,22,2,37
Epinephelus trimaculatus,16761,13,22,2,37
Cromileptes altivelis,16497,13,22,2,37
Heterodontus zebra,16720,13,22,2,37
Spinibarbus denticulatus,16549,13,22,2,37
Ischnura pumilio,15250,13,22,2,37
Psenes pellucidus,16572,13,22,2,37
Parahucho perryi,16651,13,22,2,37
Martes martes,16486,13,22,2,37
Mustela altaica,16521,13,22,2,37
Pangasianodon hypophthalmus,16522,13,22,2,37
Palinurellus wieneckii,15699,13,22,2,37
Pachygrapsus crassipes,15652,13,22,2,37
Tor putitora,16576,13,22,2,37
Elophila interruptalis,15351,13,22,2,37
Acipenser schrenckii,16684,13,22,2,37
Acrossocheilus monticola,16599,13,22,2,37
Protobothrops dabieshanensis,17193,13,22,2,37
Parabramis pekinensis,16622,13,22,2,37
Agrotis segetum,15378,13,22,2,37
Romanogobio tenuicorpus,16600,13,22,2,37
Sargassum hemiphyllum,34686,37,25,3,65
Carcharhinus macloti,16701,13,22,2,37
Regulus calendula,16859,13,22,2,37
Poecile atricapillus,16765,13,22,2,37
Chirostoma humboldtianum,16447,13,21,2,36
Siniperca obscura,16492,13,22,2,37
Gracilariopsis chorda,26534,26,23,2,51
Rhodymenia pseudopalmata,26166,24,20,2,46
Nectogale elegans,17460,13,22,2,37
Protaetia brevitarsis,20319,13,22,2,37
Sus verrucosus,16479,13,22,2,37
Loxechinus albus,15709,13,22,2,37
Neocaridina denticulata,15561,13,22,2,37
Emberiza rustica,16798,13,22,2,37
Emberiza rutila,16803,13,22,2,37
Cervaphis quercus,15272,13,22,2,37
Microphysogobio fukiensis,16600,13,22,2,37
Aliger gigas,15461,13,22,2,37
Alburnus istanbulensis,16612,13,22,2,37
Alburnus tarichi,16602,13,22,2,37
Hemicentrotus pulcherrimus,15705,13,22,2,37
Oesophagostomum asperum,13672,12,22,2,36
Oesophagostomum columbianum,13561,12,22,2,36
Eogystia hippophaecolus,15431,13,22,2,37
Contracaecum osculatum,13823,12,22,2,36
Leptobotia microphthalma,16512,13,22,2,37
Platysmacheilus exiguus,16604,13,22,2,37
Lichtheimia hongkongensis,31830,15,25,2,42
Sclerotinia borealis,203051,95,31,2,128
Petalonia fascia,38053,40,25,3,68
Scytosiphon lomentaria,36918,39,25,3,67
Fonticula alba,45189,7,29,0,36
Fonticula alba,17980,4,7,0,11
Fonticula alba,5828,3,1,0,4
Fonticula alba,10845,6,9,0,15
Netta rufina,16625,13,22,2,37
Passer montanus,16887,13,22,2,37
Gononemertes parasita,14742,13,22,2,37
Nemertopsis tetraclitophila,14597,13,22,2,37
Apocheima cinerarius,15722,13,22,2,37
Nymphes myrmeleonoides,15712,13,22,2,37
Myrmeleon immanis,15799,13,22,2,37
Schizothorax pseudoaksaiensis,16582,13,22,2,37
Elopichthys bambusa,16619,13,22,2,37
Petenia splendida,16518,13,22,2,37
Saurida umeyoshii,16546,13,22,2,37
Gnathopogon polytaenia,16594,13,22,2,37
Empoasca vitis,15154,13,22,2,37
Amphiprion frenatus,16774,13,22,2,37
Amphiprion perideraion,16579,13,22,2,37
Premnas biaculeatus,16914,13,22,2,37
Quasipaa yei,17072,13,23,2,38
Acrossocheilus kreyenbergii,16849,13,22,2,37
Percilia irwini,16621,13,22,2,37
Bostockia porosa,16477,13,22,2,37
Gadopsis bispinosus,16440,13,22,2,37
Macquaria ambigua,16502,13,22,2,37
Percalates novemaculeata,16497,13,22,2,37
Nannoperca variegata,16503,13,22,2,37
Howella brodiei,16518,13,22,2,37
Tilodon sexfasciatus,16509,13,22,2,37
Bidyanus bidyanus,16869,13,22,2,37
Musca domestica,16108,13,22,2,37
Scathophaga stercoraria,16223,13,22,2,37
Cirrhitichthys aprinus,17034,13,22,2,37
Cheilodactylus zonatus,16661,13,22,2,37
Sus celebensis,16481,13,22,2,37
Heliconius cydno,15367,13,22,2,37
Oedistoma iliolophus,16831,13,22,2,37
Vireo olivaceus,17295,13,22,2,37
Sitta carolinensis,16826,13,22,2,37
Turdus migratorius,16669,13,22,2,37
Malurus melanocephalus,15568,13,22,2,37
Tetranychus truncatus,13089,13,22,2,37
Phrynocephalus guinanensis,16279,13,22,2,37
Siniperca chuatsi x Siniperca scherzeri,16497,13,22,2,37
Plexippus paykulli,14316,13,22,2,37
Selenops bursarius,14272,13,22,2,37
Siniperca scherzeri x Siniperca chuatsi,16504,13,22,2,37
Schizopygopsis malacanthus,16677,13,22,2,37
Siganus canaliculatus,16492,13,22,2,37
Brachidontes exustus,16600,13,23,2,38
Parascaris univalens,13920,12,22,2,36
Rhodeus lighti,16677,13,22,2,37
Heteromycteris japonicus,17111,13,22,2,37
Anadara sativa,48161,12,41,2,55
Philometroides sanguineus,14378,12,22,2,36
Chlorocebus cynosuros,16334,13,22,2,37
Acrossocheilus stenotaeniatus,16594,13,22,2,37
Mastigeulota kiangsinensis,14029,13,22,2,37
Zapteryx exasperata,17310,13,22,2,37
Brycon orbignyanus,16800,13,22,2,37
Prochilodus lineatus,16699,13,22,2,37
Piaractus mesopotamicus,16722,13,22,2,37
Salminus brasiliensis,17721,13,22,2,37
Mustela nigripes,16556,13,22,2,37
Sinanodonta woodiana,16256,14,22,2,38
Zebrias zebrinus,16757,13,22,2,37
Macaca arctoides,16558,13,22,2,37
Macaca tonkeana,16560,13,22,2,37
Pardosa laura,14513,13,22,2,37
Oxyopes sertatus,14442,13,22,2,37
Channa asiatica,16550,13,22,2,37
Lernaea cyprinacea,14656,13,22,2,37
Cottus czerskii,16534,13,22,2,37
Aeolesthes oenochrous,15747,13,22,2,37
Tregellasia leucops,16759,13,22,2,37
Macaca silenus,16541,13,22,2,37
Glandirana tientaiensis,17681,13,22,2,37
Colpomenia peregrina,36025,38,25,3,66
Gloeochaete wittrockiana,36046,48,28,2,78
Aspergillus ustus,33007,18,30,2,50
Perca flavescens,16537,13,22,2,37
Pseudoxya diminuta,15541,13,22,2,37
Ardea cinerea,18703,13,23,2,38
Mus caroli,16313,13,22,2,37
Mus cervicolor,16304,13,22,2,37
Mus cookii,16307,13,22,2,37
Aporia intercostata,15144,13,22,2,37
Anthocharis bambusarum,15180,13,22,2,37
Elaphe taeniura,17183,13,22,2,37
Aquatica leii,16856,13,22,2,37
Tamias sibiricus,16558,13,22,2,37
Sorex cylindricauda,17191,13,22,2,37
Dicrocoelium chinensis,14917,12,22,2,36
Dicrocoelium dendriticum,14884,12,22,2,36
Neochauliodes rotundatus,15774,13,22,2,37
Neochauliodes fraternus,15768,13,22,2,37
Lasiopodomys mandarinus,16375,13,22,2,37
Scutopus ventrolineatus,14662,13,22,2,37
Ceracris versicolor,15616,13,22,2,37
Nipponocypris koreanus,16615,13,22,2,37
Mus fragilicauda,16312,13,22,2,37
Orthogonalys pulchella,17277,13,23,2,38
Pterois volitans,16500,13,22,2,37
Aphelenchoides besseyi,16216,12,22,2,36
Lepas australis,15502,13,22,2,37
Viverricula indica,16583,13,22,2,37
Metahomaloptera omeiensis,16558,13,22,2,37
Sillago indica,16647,13,22,2,37
Pseudacysta perseae,15850,13,22,2,37
Xenophysogobio nudicorpa,16616,13,22,2,37
Rhabdosargus sarba,16644,13,22,2,37
Ptychobarbus kaznakovi,16842,13,22,2,37
Eremias multiocellata,19385,13,22,2,37
Nibea coibor,16502,13,22,2,37
Myotis brandtii,17470,13,22,2,37
Hyla annectans,17973,13,22,2,37
Lepus sinensis,17438,13,22,2,37
Siniperca chuatsi x Siniperca knerii,16493,13,22,2,37
Tetrastes sewerzowi,16658,13,22,2,37
Discogobio yunnanensis,16602,13,22,2,37
Eremias vermiculata,19914,13,22,2,37
Homatula potanini,16569,13,22,2,37
Plutella xylostella,16014,13,22,2,37
Mictyris longicarpus,15548,13,22,2,37
Chrysomya pinguis,15838,13,23,2,38
Lissemys scutata,16512,13,22,2,37
Aeneolamia contigua,15613,13,22,2,37
Callitettix biformis,15222,13,22,2,37
Callitettix braconoides,15637,13,22,2,37
Beringraja pulchra,16907,13,22,2,37
Heliornis fulica,17009,13,22,2,37
Camaena cicatricosa,13843,13,22,2,37
Narcine entemedor,17081,13,22,2,37
Macaca fuscata,16565,13,22,2,37
Vanellus cinereus,17074,13,22,2,37
Tanakia limbata,16565,13,22,2,37
Mustela erminea,16471,13,22,2,37
Plectorhinchus lineatus,16548,13,22,2,37
Damithrax spinosissimus,15817,13,22,2,37
Thunnus atlanticus,16528,13,22,2,37
Scolopax rusticola,16984,13,22,2,37
Macrotermes natalensis,16325,13,22,2,37
Hamadryas epinome,15207,13,22,2,37
Ichthyomyzon unicuspis,16163,13,22,2,37
Oreochromis esculentus,16622,13,22,2,37
Larus crassirostris,16746,13,22,2,37
Oxytate striatipes,14407,13,22,2,37
Angaracris barabensis,15930,13,22,2,37
Neomys fodiens,17260,13,22,2,37
Gloydius intermedius,17226,13,22,2,37
Ageneiogarra imberba,16600,13,22,2,37
Bos mutus,16322,13,22,2,37
Eulimnogammarus vittatus,15534,13,23,2,38
Megalaspis cordyla,16566,13,22,2,37
Alectis ciliaris,16570,13,22,2,37
Reticulitermes chinensis,15925,13,22,2,37
Myotis davidii,17531,13,22,2,37
Tyspanodes hypsalis,15329,13,22,2,37
Loxops coccineus,15589,13,21,2,36
Haemorhous cassinii,16812,13,22,2,37
Coccothraustes coccothraustes,16823,13,22,2,37
Leucosticte arctoa,16801,13,22,2,37
Bucanetes mongolicus,16811,13,22,2,37
Melamprosops phaeosoma,16840,13,22,2,37
Cardinalis cardinalis,16779,13,22,2,37
Vestiaria coccinea,16830,13,22,2,37
Crithagra dorsostriata,16804,13,22,2,37
Magumma parva,16833,13,22,2,37
Loxia curvirostra,16805,13,22,2,37
Hemignathus stejnegeri,16832,13,22,2,37
Pyrrhula pyrrhula,16831,13,22,2,37
Spinus psaltria,16812,13,22,2,37
Oreomystis bairdi,16833,13,22,2,37
Pseudonestor xanthophrys,16830,13,22,2,37
Platysmacheilus nudiventris,16603,13,22,2,37
Triplophysa robusta,16570,13,22,2,37
Araneus ventricosus,14617,13,22,2,37
Panopea generosa,15585,13,22,2,37
Panopea globosa,15469,13,22,2,37
Vanellus vanellus,16795,13,22,2,37
Phrynocephalus helioscopus,16249,13,22,2,37
Phrynocephalus grumgrzimailoi,16301,13,22,2,37
Elaphe davidi,17117,13,22,2,37
Carangoides equula,16588,13,22,2,37
Cerion incanum,15177,13,22,2,37
Ochetobius elongatus,16613,13,22,2,37
Tenuibranchiurus glypticus,17342,13,22,2,37
Coregonus ussuriensis,16737,13,22,2,37
Chroicocephalus ridibundus,16807,13,22,2,37
Diptychus maculatus,16895,13,22,2,37
Caenorhabditis tropicalis,13874,12,22,2,36
Hydrobasileus croceus,15088,13,22,2,37
Neptis clinia,15189,13,22,2,37
Ctenoplusia limbirena,15306,13,22,2,37
Rhodopsona rubiginosa,15248,13,22,2,37
Mycalesis mineus,15267,13,22,2,37
Dendrolimus spectabilis,15411,13,22,2,37
Nomophila noctuella,15309,13,22,2,37
Aphelasterias japonica,16215,12,22,2,36
Smutsia temminckii,16559,13,22,2,37
Procypris mera,16581,13,22,2,37
Choerodon schoenleinii,16504,13,22,2,37
Scapanulus oweni,16826,13,22,2,37
Sphyrna zygaena,16731,13,22,2,37
Clupeonella cultriventris,16650,13,22,2,37
Abidama producta,15277,13,22,2,37
Sundasalanx sp. Chao Phraya,16748,13,22,2,37
Rhodeus sericeus,16581,13,22,2,37
Sorex tundrensis,17444,13,23,2,38
Squatina formosa,16690,13,22,2,37
Cricetulus longicaudatus,16302,13,22,2,37
Ulomoides dermestoides,15434,13,22,2,37
Marisa cornuarietis,15923,13,22,2,37
Poecillastra laminaris,18413,14,24,2,40
Rasbora trilineata,16747,13,22,2,37
Sillago asiatica,16493,13,22,2,37
Solenosmilia variabilis,15968,13,2,2,17
Aedes notoscriptus,15846,13,22,2,37
Fulica atra,17029,13,22,2,37
Eulabeornis castaneoventris,17421,13,22,2,37
Lewinia muelleri,17313,13,22,2,37
Liposcelis entomophila,11599,11,0,0,11
Liposcelis entomophila,12675,1,14,2,17
Gallirallus philippensis,17359,13,22,2,37
Porphyrio porphyrio,17020,13,22,2,37
Mactra chinensis,17285,12,21,2,35
Callosciurus erythraeus,16550,13,22,2,37
Ichthyomyzon fossor,16150,13,22,2,37
Petrolisthes haswelli,15348,13,22,2,37
Sarcophaga similis,15158,13,22,2,37
Sarcophaga portschinskyi,14929,13,22,2,37
Pelophylax cretensis,17829,13,22,2,37
Coregonus peled,16736,13,22,2,37
Cipangopaludina cathayensis,17157,13,22,2,37
Squatina nebulosa,16698,13,22,2,37
Accipiter nisus,18647,13,22,2,37
Ibacus ciliatus,15696,13,22,2,37
Eudontomyzon morii,16172,13,22,2,37
Lampetra appendix,16169,13,22,2,37
Hypostomus plecostomus,16523,13,22,2,37
Platydoras armatulus,16470,13,22,2,37
Callithrix jacchus,16499,13,22,2,37
Siganus vulpinus,16505,13,22,2,37
Hucho hucho,16751,13,22,2,37
Ctenopharyngodon idellus x Elopichthys bambusa,16608,13,22,2,37
Amolops wuyiensis,17797,13,22,2,37
Enoplometopus debelius,15641,13,22,2,37
Uragus sibiricus,16802,13,22,2,37
Serinus albogularis,16810,13,22,2,37
Thraupis episcopus,16757,13,22,2,37
Carpodacus erythrinus,16820,13,22,2,37
Loxops mana,16714,13,22,2,37
Fringilla coelebs,16801,13,22,2,37
Hesperiphona vespertina,16810,13,22,2,37
Paroreomyza montana,16832,13,22,2,37
Himatione sanguinea,16840,13,22,2,37
Leucosticte brandti,16798,13,22,2,37
Loxops caeruleirostris,16829,13,22,2,37
Chlorophanes spiza,16824,13,22,2,37
Carpodacus roseus,16796,13,22,2,37
Hemignathus flavus,16835,13,22,2,37
Pinicola enucleator,16818,13,22,2,37
Haemorhous mexicanus,16822,13,22,2,37
Passer domesticus,16802,13,22,2,37
Anser indicus,16731,13,22,2,37
Seriolella porosa,16814,13,22,2,37
Gloydius saxatilis,17218,13,22,2,37
Oreochromis niloticus x Oreochromis aureus,16663,13,22,2,37
Leopoldamys edwardsi,16284,13,22,2,37
Andinoacara rivulatus,16585,13,22,2,37
Akodon montensis,16378,13,22,2,37
Wiedomys cerradensis,16346,13,22,2,37
Lepus tolai,17472,13,22,2,37
Clibanarius infraspinatus,16504,13,22,2,37
Uroplatus fimbriatus,16780,13,22,2,37
Gymnocephalus cernua,16614,13,22,2,37
Chrysolampis mosquitus,16767,13,22,2,37
Lepus hainanus,16646,13,22,2,37
Samaris cristatus,18606,13,23,2,38
Montifringilla nivalis,16923,13,22,2,37
Pyrgilauda blanfordi,16913,13,22,2,37
Montifringilla adamsi,16912,13,22,2,37
Onychostruthus taczanowskii,16917,13,22,2,37
Pyrgilauda davidiana,16912,13,22,2,37
Ardea modesta,19212,13,22,2,37
Bubulcus ibis,18959,13,22,2,37
Ardea intermedia,18543,13,22,2,37
Ardea purpurea,18722,13,23,2,38
Egretta sacra,19656,14,25,2,41
Ardeola bacchus,19341,14,25,2,41
Butorides striata,19087,14,25,2,41
Botaurus stellaris,20350,14,25,2,41
Ixobrychus eurhythmus,19509,14,25,2,41
Ixobrychus sinensis,19493,14,25,2,41
Pyrrhocorax pyrrhocorax,16889,13,22,2,37
Pyrrhocorax graculus,16905,13,22,2,37
Eremias przewalskii,18225,13,22,2,37
Euthynnus affinis,16513,13,22,2,37
Argyrosomus amoyensis,16490,13,22,2,37
Takifugu flavidus x Takifugu rubripes,16443,13,22,2,37
Oedalechilus labiosus,16829,13,22,2,37
Eucryptorrhynchus brandti,15122,13,21,2,36
Angaracris rhodopa,15930,13,22,2,37
Parasinilabeo assimilis,16602,13,22,2,37
Prays oleae,16499,13,22,2,37
Murina leucogaster,16823,13,22,2,37
Ichthyoelephas longirostris,16840,13,22,2,37
Curimata mivartii,16705,13,22,2,37
Mus spretus,16286,13,22,2,37
Chelmon rostratus,16538,13,22,2,37
Mobula eregoodootenkee,15716,13,22,2,37
Globicephala macrorhynchus,16390,13,22,2,37
Tetragnatha maxillosa,14414,13,22,2,37
Dilutineuron laevigatum,106809,39,24,3,66
Auxenochlorella protothecoides,57274,39,26,3,68
Berkeleya fennica,35509,36,25,2,63
Saccharina latissima,37659,38,23,4,65
Phoebastria nigripes,19072,14,25,2,41
Phoebastria immutabilis,19088,14,25,2,41
Phoebastria albatrus,19097,14,25,2,41
Sebastes owstoni,16465,13,22,2,37
Narella hawaiiensis,18838,14,1,2,17
Temnopleurus hardwickii,15696,13,22,2,37
Maculabatis gerrardi,17685,13,22,2,37
Portunus pelagicus,16157,13,22,2,37
Taeniura lymma,17652,13,22,2,37
Sorubim cuspicaudus,16544,13,22,2,37
Vanmanenia pingchowensis,16560,13,22,2,37
Pseudocarcharias kamoharai,16694,13,22,2,37
Bangana decora,16607,13,22,2,37
Atule mate,16565,13,22,2,37
Lagocephalus suezensis,16494,13,22,2,37
Sibogagorgia cauliflora,19030,14,1,2,17
Ravinia pernix,15778,13,22,2,37
Perca fluviatilis,16537,13,22,2,37
Anisakis berlandi,13915,12,22,2,36
Heosemys depressa,16773,13,22,2,37
Tubastraea coccinea,19070,13,2,2,17
Dendrophyllia cribrosa,19072,13,2,2,17
Cyclemys pulchristriata,16527,13,22,2,37
Chitra indica,16726,13,22,2,37
Hynobius kimurae,16448,13,22,2,37
Hynobius nigrescens,16412,13,22,2,37
Myospalax psilurus,16360,13,22,2,37
Gastrocopta cristata,14060,13,22,2,37
Pupilla muscorum,14149,13,22,2,37
Vertigo pusilla,14078,13,22,2,37
Gonepteryx rhamni,15203,13,22,2,37
Elseya branderhorsti,16444,13,22,2,37
Emydura subglobosa,16442,13,22,2,37
Platemys platycephala,16553,13,22,2,37
Euphaea yayeyamana,15709,13,22,2,37
Euphaea decorata,15861,13,22,2,37
Euphaea ornata,15863,13,22,2,37
Callerebia suroia,15208,13,22,2,37
Elymnias hypermnestra,15167,13,22,2,37
Phoenicurus auroreus,16772,13,22,2,37
Tarsiger cyanurus,16803,13,22,2,37
Garrulax perspicillatus,17873,13,22,2,37
Ariadne ariadne,15179,13,22,2,37
Cethosia biblis,15211,13,22,2,37
Cyrestis thyodamas,15254,13,22,2,37
Hypolimnas bolina,15260,13,22,2,37
Polyura nepenthes,15333,13,22,2,37
Dicentrarchus labrax,18253,13,22,2,37
Dicentrarchus punctatus,17511,13,22,2,37
Zorotypus medoensis,14572,13,22,2,37
Brachirus orientalis,16600,13,22,2,37
Tyrophagus putrescentiae,13288,13,19,2,34
Coptodon zillii,16619,13,22,2,37
Propithecus diadema,17084,13,22,2,37
Varecia variegata,17051,13,22,2,37
Propithecus edwardsi,17100,13,22,2,37
Megaladapis edwardsi,16781,13,22,2,37
Palaeopropithecus ingens,16910,13,22,2,37
Indri indri,17098,13,22,2,37
Eulemur rubriventer,17534,13,22,2,37
Sebastes longispinis,16445,13,22,2,37
Demodex folliculorum,14150,13,22,2,37
Acroneuria hainana,15804,13,22,2,37
Goniurosaurus luii,16519,13,22,2,37
Didemnum vexillum,13424,12,24,2,38
Oreochromis variabilis,16626,13,22,2,37
Isognathotermes ugandensis,16491,13,23,2,38
Microcerotermes parvus,16916,13,23,2,38
Nasutitermes corniger,16122,13,23,2,38
Neocapritermes taracua,16346,13,22,2,37
Termes hospes,16461,13,22,2,37
Megalobrama amblycephala x Megalobrama hoffmanni,16623,13,22,2,37
Sinibrama taeniatus,16623,13,22,2,37
Macaca nigra,16564,13,22,2,37
Devario laoensis,16565,13,22,2,37
Wadicosa fidelis,14741,13,22,2,37
Rhizomys sinensis,16564,13,22,2,37
Stercorarius maccormicki,16669,13,22,2,37
Parabotia banarescui,16590,13,22,2,37
Parabotia fasciatus,16590,13,22,2,37
Spinibarbus hollandi,16521,13,22,2,37
Leptobotia taeniops,16592,13,22,2,37
Episoriculus caudatus,17129,13,22,2,37
Formica fusca,16673,13,22,2,37
Myrmica scabrinodis,15310,13,22,2,37
Pelotretis flavilatus,16937,13,22,2,37
Himantura microphthalma,17636,13,22,2,37
Triaenodon obesus,16700,13,22,2,37
Perna perna,18415,12,23,2,37
Neoscona theisi,14156,13,22,2,37
Muscina stabulans,15933,13,22,2,37
Schizothorax lantsangensis,16580,13,22,2,37
Pomacanthus xanthometopon,16533,13,22,2,37
Pomacanthus imperator,16538,13,22,2,37
Brachythemis contaminata,15056,13,22,2,37
Cuneopsis pisciculus,15907,13,22,2,37
Anoxypristis cuspidata,17243,13,22,2,37
Urosaurus nigricaudus,17298,13,22,2,37
Brachyuropus grewingkii,17118,13,22,2,37
Homologenus malayensis,15793,13,22,2,37
Tegillarca granosa,31589,12,23,2,37
Accipiter virgatus,17952,13,22,2,37
Stichophanes ningshaanensis,17292,13,22,2,37
Acrasis kona,51458,37,13,2,52
Paracercomonas marina,35796,25,17,3,45
Malawimonas californiana,36792,39,25,3,67
Stachyamoeba lipophora,49742,48,21,2,71
Protobothrops maolanensis,17228,13,22,2,37
Fusarium graminearum,95676,50,28,2,80
Paracymoriza prodigalis,15326,13,22,2,37
Pseudanomodon attenuatus,104252,40,24,3,67
Equus grevyi,16403,13,22,2,37
Hongeo koreana,16905,13,22,2,37
Fulvia mutica,19110,13,27,2,42
Exophiala dermatitidis NIH/UT8656,26004,16,25,0,41
Neurospora crassa OR74A,64840,28,28,0,56
Trichinella pseudospiralis,17667,13,22,2,37
Trichinella britovi,16421,13,22,2,37
Trichinella murrelli,16592,13,22,2,37
Trichinella nativa,14077,13,22,2,37
Trichinella nelsoni,15278,13,22,2,37
Trichinella papuae,17326,13,22,2,37
Trichinella zimbabwensis,14244,13,22,2,37
Striacosta albicosta,15553,13,22,2,37
Macropodus opercularis,16496,13,22,2,37
Tylorrhynchus heterochaetus,16106,13,22,2,37
Amynthas aspergillus,15115,13,22,2,37
Dremomys rufigenis,16545,13,22,2,37
Hylopetes phayrei,16530,13,22,2,37
Centropyge interrupta,16151,13,22,2,37
Thecamonas trahens,31217,33,24,3,60
Holacanthus clarionensis,16615,13,22,2,37
Phrynocephalus forsythii,17542,13,22,2,37
Neosalanx tangkahkeii,16550,13,22,2,37
Parnassius cephalus,15343,13,22,2,37
Megalobrama pellegrini,16620,13,22,2,37
Spilopelia chinensis,16966,13,22,2,37
Rhinolophus macrotis,16848,13,22,2,37
Corvus brachyrhynchos,16917,13,22,2,37
Heliconius ismenius,15346,13,22,2,37
Epinephelus coioides x Epinephelus lanceolatus,16418,13,22,2,37
Cynopterus brachyotis,16701,13,22,2,37
Balanus balanus,15955,13,22,2,37
Hyporhamphus intermedius,16720,13,22,2,37
Hylaeus dilatatus,15475,13,22,2,37
Southwellina hispida,14742,12,22,2,36
Japonica lutea,15225,13,22,2,37
Bombyx huttoni,15638,13,22,2,37
Mugilogobius chulae,16489,13,22,2,37
Apolemichthys kingi,16816,13,22,2,37
Chaetodontoplus mesoleucus,16998,13,22,2,37
Hyla tsinlingensis,18295,13,22,2,37
Sinotmethis brachypterus,15662,13,22,2,37
Pseudoplatystoma magdaleniatum,16568,13,22,2,37
Pavona decussata,18378,13,2,2,17
Ictiobus cyprinellus,16611,13,22,2,37
Vulpes lagopus,16656,13,22,2,37
Pseudosiderastrea tayamai,19475,13,2,2,17
Pieris canidia,15153,13,22,2,37
Sander lucioperca,16542,13,22,2,37
Sarocladium implicatum,22376,12,17,2,31
Pteropus vampyrus,16554,13,22,2,37
Tachysurus fulvidraco x Tachysurus vachelli,16527,13,22,2,37
Crossoptilon harmani,16682,13,22,2,37
Crossoptilon mantchuricum,16690,13,22,2,37
Onychostoma gerlachi,16601,13,22,2,37
Gloydius ussuriensis,17208,13,22,2,37
Strigamia maritima,14983,13,15,2,30
Tridacna squamosa,20930,12,24,2,38
Cherax tenuimanus,15797,13,22,2,37
Austropotamobius pallipes,15679,13,22,2,37
Faxonius limosus,16223,13,22,2,37
Heliconius sara,15372,13,22,2,37
Hypomesus olidus,16786,13,22,2,37
Chitoria ulupi,15279,13,22,2,37
Euastacus armatus,15555,13,22,2,37
Lepas anserifera,15657,13,22,2,37
Parachaenichthys charcoti,18202,13,23,2,38
Poecilia sphenops,16533,13,22,2,37
Betta splendens,16980,13,22,2,37
Sargassum thunbergii,34748,37,25,3,65
Dunaliella viridis,45980,8,3,9,20
Polytoma uvella,17411,7,3,9,19
Niphotrichum ericoides,106727,39,24,3,66
Chlamydomonas leiostraca,14029,7,3,9,19
Heterosigma akashiwo,38690,41,25,3,69
Chattonella marina,44772,41,25,3,69
Leptidea morsei,15122,13,22,2,37
Catopsilia pomona,15142,13,22,2,37
Arctica islandica,18289,12,22,2,36
Pochonia chlamydosporia,25615,15,22,2,39
Cuora trifasciata,16675,13,22,2,37
Campylomormyrus compressirostris,16715,13,22,2,37
Beatragus hunteri,16359,13,22,2,37
Damaliscus lunatus,16419,13,22,2,37
Helicoverpa punctigera,15382,13,22,2,37
Amphiporus formidabilis,14616,13,22,2,37
Nipponnemertes punctatula,15354,13,22,2,37
Prosadenoporus spectaculum,14655,13,22,2,37
Meloidogyne incognita,17662,12,22,2,36
Mimachlamys nobilis,17963,12,20,2,34
Ganoderma meredithae,78447,33,29,2,64
Codriophorus aciculare,106818,39,24,3,66
Agarophyton chilense,26898,25,25,2,52
Saprolegnia parasitica CBS 223.65,38376,33,28,0,61
Chromodoris magnifica,14446,12,22,2,36
Acerentomon microrhinus,15213,13,22,2,37
Sarcophaga crassipalpis,15420,13,22,2,37
Phormia regina,15513,13,24,2,39
Peirates fulvescens,15702,13,22,2,37
Peirates atromaculatus,16314,13,22,2,37
Peirates turpis,15703,13,22,2,37
Peirates lepturoides,15932,13,22,2,37
Anodonta lucida,16285,13,22,2,37
Anodonta arcaeformis,15672,13,22,2,37
Acerella muscorum,15018,13,21,2,36
Lanceolaria grayii,15736,13,22,2,37
Gongylonema pulchrum,13798,12,22,2,36
Umalia orientalis,15466,13,22,2,37
Symphysodon discus,16544,13,22,2,37
Lemyra melli,15418,13,22,2,37
Hemiculterella sauvagei,16618,13,22,2,37
Reticulitermes aculabialis,16475,13,22,2,37
Carcharhinus amboinensis,16704,13,22,2,37
Promalactis suzukiella,15507,13,22,2,37
Pseudohynobius jinfo,16393,13,22,2,37
Pardaliparus venustulus,16778,13,22,2,37
Tribolium confusum,15813,13,22,2,37
Streptocephalus sirindhornae,16887,13,22,2,37
Cynomys leucurus,16454,13,22,2,37
Cynomys ludovicianus,16466,13,22,2,37
Sinobdella sinensis,16540,13,22,2,37
Phallocryptus tserensodnomi,16493,13,22,2,37
Formica selysi,16752,13,22,2,37
Pseudolaubuca sinensis,16617,13,22,2,37
Falco cherrug,18059,13,22,2,37
Fruhstorferiola kulinga,15655,13,22,2,37
Ageneiosus pardalis,16484,13,22,2,37
Decapterus macarellus,16544,13,22,2,37
Eucryptorrhynchus scrobiculatus,15628,13,21,2,36
Lyreidus brevifrons,16112,13,22,2,37
Urocyon cinereoargenteus,16469,13,22,2,37
Apostichopus californicus,16727,13,22,2,37
Saxidomus purpurata,19637,12,22,2,36
Triodontophorus brevicauda,14305,12,22,2,36
Chthamalus antennatus,15165,13,22,2,37
Epinephelus corallicola,16647,13,22,2,37
Hemitriakis japanica,17301,13,22,2,37
Corvus hawaiiensis,16898,13,22,2,37
Nanorana parkeri,17837,13,23,2,38
Anemina euscaphys,15741,13,22,2,37
Sylviparus modestus,17086,13,22,2,37
Trichogaster fasciata,16635,13,22,2,37
Siboglinum fiordicum,19502,13,22,2,37
Asparagopsis taxiformis,26097,25,23,2,50
Shiraia bambusicola,39030,17,31,2,50
Niphotrichum elongatum,106746,39,24,3,66
Frisvollia varia,106358,39,24,3,66
Aneura pinguis,165603,40,27,3,70
Bangia fuscopurpurea,43517,31,23,2,56
Protobothrops mangshanensis,17230,13,22,2,37
Aspergillus flavus,31602,17,31,2,50
Bucklandiella orthotrichacea,107215,39,24,3,66
Racomitrium emersum,107186,39,24,3,66
Fusarium culmorum,103844,60,28,2,90
Cyanoptyche gloeocystis,33240,39,26,3,68
Agarophyton vermiculophyllum,25971,25,21,2,48
Epigonichthys cultellus,14991,13,22,2,37
Gonepteryx mahaguru,15221,13,22,2,37
Ninguta schrenckii,15261,13,22,2,37
Eutelia adulatricoides,15360,13,22,2,37
Risoba prominens,15343,13,22,2,37
Gabala argentata,15337,13,22,2,37
Vamuna virilis,15417,13,22,2,37
Lophiosilurus alexandri,16445,13,22,2,37
Pseudoplatystoma corruscans,16123,13,22,2,37
Cyanoplax caverna,15141,13,22,2,37
Nuttallina californica,15604,13,22,2,37
Cryptochiton stelleri,15082,13,22,2,37
Spirometra decipiens,13641,12,22,2,36
Onychodactylus zhangyapingi,16537,13,22,2,37
Sclerolinum brattstromi,15383,13,22,2,37
Escarpia spicata,15445,13,22,2,37
Galathealinum brachiosum,14779,13,22,2,37
Lamellibrachia luymesi,14991,13,22,2,37
Oasisia alvinae,14849,13,22,2,37
Riftia pachyptila,14987,13,22,2,37
Seepiophila jonesi,15092,13,22,2,37
Tevnia jerichonana,14891,13,22,2,37
Argyroneta aquatica,16000,13,22,2,37
Parnassius epaphus,15458,13,22,2,37
Pelecinus polyturator,14896,13,22,2,37
Nemopoda mamaevi,15878,13,22,2,37
Zootoca vivipara,17046,13,22,2,37
Strongylus equinus,14545,12,22,2,36
Cyprinus carpio specularis x Carassius cuvieri,16584,13,22,2,37
Carcharhinus tjutjot,16705,13,22,2,37
Acheilognathus barbatus,16770,13,22,2,37
Brycon henni,16885,13,22,2,37
Micrura ignea,15333,13,22,2,37
Tamiops swinhoei,16513,13,22,2,37
Chaetodontoplus conspicillatus,16988,13,22,2,37
Penaeus merguiensis,16023,13,22,2,37
Penaeus penicillatus,16040,13,22,2,37
Oxyeleotris lineolata,16519,13,22,2,37
Ophiodon elongatus,16528,13,22,2,37
Hexagrammos lagocephalus,16505,13,22,2,37
Erilepis zonifer,16500,13,22,2,37
Pelophylax cypriensis,18023,13,22,2,37
Pelophylax epeiroticus,18030,13,22,2,37
Pelophylax kurtmuelleri,18020,13,22,2,37
Pelophylax shqipericus,17366,13,22,2,37
Diploprion bifasciatum,16805,13,24,2,39
Cheilodactylus variegatus,16652,13,22,2,37
Abbottina obtusirostris,16599,13,22,2,37
Eleotris oxycephala,16527,13,22,2,37
Melanotaenia parkinsoni,16529,13,22,2,37
Illex argentinus,20278,17,23,2,42
Graphium chironides,15235,13,22,2,37
Poecile palustris,16824,13,22,2,37
Coilia brachygnathus,16858,13,22,2,37
Daphnia magna,14948,13,22,2,37
Myospalax aspalax,16436,13,22,2,37
Lampetra aepyptera,16236,13,22,2,37
Parachromis managuensis,16526,13,22,2,37
Selenotoca multifasciata,16646,13,22,2,37
Cyclemys dentata,16489,13,22,2,37
Aethaloperca rogaa,16538,13,22,2,37
Arborophila ardens,16728,13,22,2,37
Luciogobius pallidus,16480,13,22,2,37
Sterechinus neumayeri,15684,13,22,2,37
Holothuria scabra,15779,13,22,2,37
Cacopsylla coccinea,14832,13,22,2,37
Polydactylus sextarius,16836,13,22,2,37
Cyclura pinguis,16631,13,22,2,37
Callimorpha dominula,15496,13,22,2,37
Discosoma nummiforme,20925,13,2,2,17
Acrossocheilus parallens,16592,13,22,2,37
Macaca nemestrina,16560,13,22,2,37
Nephotettix cincticeps,14805,13,22,2,37
Gnathostomula armata,14030,13,19,2,34
Gnathostomula paradoxa,14197,13,20,2,35
Lepidodermella squamata,14558,13,22,2,37
Melibe leonina,14513,13,22,2,37
Tritonia tetraquetra,14540,13,22,2,37
Synanceia verrucosa,16506,13,22,2,37
Zinaida jigongi,15353,13,22,2,37
Sus barbatus,16480,13,22,2,37
Scombrops boops,16518,13,22,2,37
Goniada japonica,15327,13,22,2,37
Aldrichina grahami,14903,13,22,2,37
Strongylura anastomella,16534,13,22,2,37
Elaphe anomala,17164,13,22,2,37
Bangana tungting,16543,13,22,2,37
Thamnaconus hypargyreus,16438,13,22,2,37
Antheraea frithi,15338,13,22,2,37
Carcharhinus brevipinna,16706,13,22,2,37
Clinostomum complanatum,13796,12,22,2,36
Lynx lynx,17046,13,22,2,37
Tanakia himantegus,16575,13,22,2,37
Plectorhinchus orientalis,16546,13,22,2,37
Plectorhinchus vittatus,16545,13,22,2,37
Amplexidiscus fenestrafer,20188,13,2,2,17
Corynactis californica,20715,13,2,2,17
Rhodactis indosinensis,20100,13,2,2,17
Platyzoanthus mussoides,20826,13,2,2,17
Ricordea yuma,22015,13,2,2,17
Pterocryptis cochinchinensis,16501,13,22,2,37
Euripus nyctelius,15417,13,22,2,37
Biston suppressaria,15628,13,22,2,37
Ogmocotyle sikae,14307,12,22,2,36
Galeruca daurica,16615,13,22,2,37
Catopuma temminckii,16985,13,22,2,37
Rimicaris exoculata,15902,13,22,2,37
Colletotrichum graminicola M1.001,39649,16,25,0,41
Culter compressocorpus,16623,13,22,2,37
Callicladium imponens,103830,40,24,3,67
Ulota hutchinsiae,104608,40,24,3,67
Buxbaumia aphylla,100725,39,24,3,66
Bartramia pomiformis,106198,40,24,3,67
Atrichum angustatum,115146,40,24,3,67
Sphagnum palustre,141276,40,24,3,67
Orthotrichum stellatum,104131,40,24,3,67
Funaria hygrometrica,109586,40,24,3,67
Tenebrio molitor,15785,13,22,2,37
Tadorna ferruginea,16639,13,22,2,37
Tetranychus kanzawai,13091,13,22,2,37
Tetranychus ludeni,13064,13,22,2,37
Tetranychus malaysiensis,13049,13,22,2,37
Tetranychus phaselus,13084,13,22,2,37
Tetranychus pueraricola,13084,13,22,2,37
Aegithalos fuliginosus,17953,13,22,2,37
Aegithalos bonvaloti,17953,13,22,2,37
Aegithalos glaucogularis,17937,13,22,2,37
Ptychomnion cygnisetum,104480,39,24,3,66
Brontostoma colossus,16625,13,23,2,38
Hyliota flavigaster,16218,13,22,2,37
Parasitella parasitica,83361,42,26,2,70
Bothus pantherinus,17271,13,22,2,37
Citharoides macrolepidotus,16497,13,23,2,38
Crossorhombus kobensis,16696,13,22,2,37
Cyclopsetta fimbriata,16506,13,22,2,37
Laeops lanceolata,18436,13,22,2,37
Lepidoblepharon ophthalmolepis,16805,13,22,2,37
Neoachiropsetta milfordi,16623,13,22,2,37
Capreolus pygargus,16357,13,22,2,37
Thitarodes gonggaensis,15940,13,22,2,37
Allonautilus scrobiculatus,16132,13,22,2,37
Neophocaena asiaeorientalis,16385,13,22,2,37
Saccharomyces cerevisiae,78917,8,24,2,34
Adelphocoris lineolatus,15595,13,22,2,37
Adelphocoris nigritylus,14522,13,22,2,37
Dendrolimus punctatus,15411,13,22,2,37
Dendrolimus tabulaeformis,15411,13,22,2,37
Odontobutis yaluensis,16988,13,22,2,37
Schizothorax lissolabiata,16583,13,22,2,37
Coreoperca herzi,16495,13,22,2,37
Microphysogobio yaluensis,16601,13,22,2,37
Kichulchoia multifasciata,16569,13,22,2,37
Liobagrus mediadiposalis,16534,13,22,2,37
Sinocyclocheilus rhinocerous,16588,13,22,2,37
Sinocyclocheilus anshuiensis,16618,13,22,2,37
Hasora vitta,15282,13,22,2,37
Scortum barcoo,16843,13,22,2,37
Corvus macrorhynchos,16927,13,22,2,37
Loxostege sticticalis,15218,13,22,2,37
Ambastaia sidthimunki,16574,13,22,2,37
Sclerotia substriata,16248,13,22,2,37
Squilloides leptosquilla,16376,13,22,2,37
Trilophidia annulata,15775,13,22,2,37
Platycnemis foliacea,15382,13,22,2,37
Atrocalopteryx atrata,15424,13,22,2,37
Pristis pectinata,16802,13,22,2,37
Seriola rivoliana,16530,13,22,2,37
Qinlingacris taibaiensis,15774,13,22,2,37
Tarimichthys bombifrons,16569,13,22,2,37
Oxyuris equi,13641,12,22,2,36
Barbatula barbatula,16630,13,22,2,37
Chaenogobius gulosus,16477,13,22,2,37
Siniperca knerii x Siniperca chuatsi,16488,13,22,2,37
Eopsaltria griseogularis,16771,13,22,2,37
Eopsaltria georgiana,16771,13,22,2,37
Tregellasia capito,16764,13,22,2,37
Bison priscus,16318,13,22,2,37
Enchelynassa canina,16592,13,22,2,37
Nyctalus noctula,17478,13,22,2,37
Trichopodus microlepis,16435,13,22,2,37
Planiliza macrolepis,16832,13,22,2,37
Gymnomuraena zebra,16576,13,22,2,37
Aethopyga gouldiae,16893,13,22,2,37
Crocidura orientalis,15452,13,22,2,37
Crocidura palawanensis,15458,13,22,2,37
Crocidura ninoyi,15455,13,22,2,37
Crocidura negrina,15455,13,22,2,37
Crocidura panayensis,15456,13,22,2,37
Crocidura grayi,15459,13,22,2,37
Crocidura mindorus,15458,13,22,2,37
Crocidura beatus,15456,13,22,2,37
Emberiza jankowskii,16776,13,22,2,37
Colias erate,15184,13,22,2,37
Zeugodacus scutellatus,15915,13,22,2,37
Gnathopogon imberbis,16598,13,22,2,37
Asbolus verrucosus,15828,13,22,2,37
Metaphire californica,15147,13,22,2,37
Amynthas gracilis,15161,13,22,2,37
Tinamus guttatus,16750,13,22,2,37
Uta stansburiana,16703,13,22,2,37
Hasora anura,15290,13,22,2,37
Phalacrocorax carbo,18995,14,25,2,41
Aluterus monoceros,16429,13,22,2,37
Gnathopogon taeniellus,16596,13,22,2,37
Calicophoron microbothrioides,14028,12,22,2,36
Phoxinus oxycephalus,16606,13,22,2,37
Phaethon lepturus,17773,13,22,2,37
Coregonus autumnalis,16736,13,22,2,37
Ictidomys tridecemlineatus,16458,13,22,2,37
Tetraogallus himalayensis,16692,13,22,2,37
Terapon jarbua,16570,13,22,2,37
Spermophilus dauricus,16512,13,22,2,37
Prunella montanella,16832,13,22,2,37
Acanthis flammea,16820,13,22,2,37
Haplochromis burtoni,16583,13,22,2,37
Zeugodacus tau,15687,13,22,2,37
Beaufortia szechuanensis,16559,13,22,2,37
Gossypium hirsutum,668584,34,29,4,67
Gossypium harknessii,666081,33,28,4,65
Turbinaria ornata,34981,37,24,3,64
Penicillium roqueforti,29908,19,27,1,47
Pseudogymnoascus pannorum,26918,15,27,2,44
Torulaspora delbrueckii,28793,8,24,2,34
Thymallus pallasii,16663,13,22,2,37
Thymallus tugarinae,16662,13,22,2,37
Thymallus yaluensis,16659,13,22,2,37
Thymallus burejensis,16664,13,22,2,37
Thymallus brevirostris,16658,13,22,2,37
Gandalfus puia,15548,13,22,2,37
Acipenser sturio,16555,13,22,2,37
Eothenomys melanogaster,16331,13,22,2,37
Recurvirostra avosetta,16897,13,22,2,37
Tylototriton taliangensis,16265,13,22,2,37
Macropus giganteus,16887,13,22,2,37
Hyperolius marmoratus,22595,13,22,2,37
Torulaspora pretoriensis,33343,8,24,2,34
Torulaspora franciscae,39201,9,23,2,34
Torulaspora globosa,45193,11,24,2,37
Sargassum vachellianum,34877,37,25,3,65
Diaporthe longicolla,53439,12,25,2,39
Syntrichia filaris,106343,40,24,3,67
Triplophysa yarkandensis,16574,13,22,2,37
Tetrahymena thermophila,47577,45,8,6,59
Giraffa camelopardalis,16433,13,22,2,37
Agkistrodon piscivorus,17213,13,22,2,37
Falco columbarius,17516,13,22,2,37
Genicanthus semifasciatus,16722,13,22,2,37
Pyropia nitida,35313,28,17,2,47
Anguis fragilis,17479,13,22,2,37
Isurus oxyrinchus,16701,13,22,2,37
Carettochelys insculpta,16439,13,22,2,37
Carcharhinus longimanus,16706,13,22,2,37
Macrognathus aculeatus,16537,13,22,2,37
Rhodeus fangi,16733,13,22,2,37
Sebastes vulpes,16462,13,22,2,37
Sebastes taczanowskii,16452,13,22,2,37
Sebastes hubbsi,16453,13,22,2,37
Spoladea recurvalis,15273,12,22,2,36
Sebastes minor,16408,13,22,2,37
Sebastes steindachneri,16450,13,22,2,37
Sebastes trivittatus,16409,13,22,2,37
Sebastes thompsoni,16405,13,22,2,37
Macaca cyclopis,16563,13,22,2,37
Rhacophorus dennysi,18052,13,22,2,37
Hylocharis cyanus,16817,13,22,2,37
Oreotrochilus melanogaster,16859,13,22,2,37
Florisuga mellivora,16739,13,22,2,37
Haplothrips aculeatus,14616,12,22,2,36
Eurydema gebleri,16005,13,22,2,37
Carrhotus xanthogramma,14563,13,22,2,37
Dolicheulota formosensis,14237,13,22,2,37
Ochlerotatus vigilax,15877,13,22,2,37
Botia lohachata,16594,13,22,2,37
Calidris pygmaea,16707,13,22,2,37
Pateobatis hortlei,17688,13,22,2,37
Tor tor,16554,13,22,2,37
Dipus sagitta,16664,13,22,2,37
Euchoreutes naso,16705,13,22,2,37
Ambystoma bishopi,16361,13,22,2,37
Anopheles culicifacies B,15330,13,22,2,37
Pomacea maculata,15516,13,22,2,37
Eudocimus ruber,16697,13,22,2,37
Tylototriton shanjing,16661,13,22,2,37
Papilio demoleus,15249,13,22,2,37
Tylototriton wenxianensis,16265,13,22,2,37
Heliconius clysonymus,15302,13,22,2,37
Dipturus trachyderma,16907,13,22,2,37
Acipenser schrenckii x Huso dauricus,16687,13,22,2,37
Aegorhinus superciliosus,15121,13,21,2,36
Eozapus setchuanus,16573,13,22,2,37
Sicista concolor,16492,13,22,2,37
Prosopocoilus gracilis,16736,13,22,2,37
Orestias ascotanensis,16617,13,22,2,37
Odontobutis interrupta,16802,13,22,2,37
Aegista diversifamilia,14039,13,22,2,37
Holacanthus africanus,16819,13,22,2,37
Holacanthus tricolor,16625,13,22,2,37
Icelus spatula,16384,13,22,2,37
Leptoclinus maculatus,16524,13,22,2,37
Dendrophyllia arbuscula,19069,13,2,2,17
Parochlus steinenii,16803,13,22,2,37
Mesoplodon ginkgodens,16339,13,22,2,37
Holacanthus passer,16620,13,22,2,37
Holacanthus ciliaris,16606,13,22,2,37
Genicanthus bellus,16734,13,22,2,37
Centropyge venusta,16641,13,22,2,37
Centropyge multifasciata,16502,13,22,2,37
Palaemon serenus,15967,13,22,2,37
Macrobrachium bullatum,15774,13,22,2,37
Paratya australiensis,15990,13,22,2,37
Macaca leonina,17050,13,22,2,37
Elaphe schrenckii,17165,13,22,2,37
Asio flammeus,18966,13,22,2,37
Metanephrops thomsoni,19835,13,24,2,39
Amblyomma americanum,14709,13,22,2,37
Alicia sansibarensis,19575,14,2,2,18
Antholoba achates,17816,15,2,2,19
Phymanthus crucifer,19727,14,2,2,18
Sagartia ornata,17446,14,2,2,18
Tor khudree,16573,13,22,2,37
Hirsutella minnesotensis,52245,30,25,2,57
Crella elegans,18543,14,24,2,40
Porites rus,18647,13,8,2,23
Ophiophagus hannah,17267,13,23,2,38
Tridentiger bifasciatus,16532,13,22,2,37
Chroicocephalus brunnicephalus,16769,13,22,2,37
Tridentiger barbatus,16522,13,22,2,37
Echinococcus equinus,13605,12,22,2,36
Cirrhigaleus australis,16544,13,22,2,37
Amazilia versicolor,16861,13,22,2,37
Dastarcus helophoroides,15878,13,22,2,37
Scirtothrips dorsalis,15343,13,22,2,37
Uncinaria sanguinis,13753,12,22,2,36
Ocypode ceratophthalmus,15564,13,22,2,37
Cyclograpsus granulosus,16300,13,22,2,37
Megaleporinus piavussu,16682,13,22,2,37
Geotrichum candidum,29008,15,21,2,38
Lewinskya speciosa,104747,40,24,3,67
Grundulus bogotensis,17123,13,22,2,37
Zinaida nascens,15392,13,22,2,37
Pterophyllum scalare,16491,13,22,2,37
Oncorhynchus mykiss x Salmo salar,16658,13,22,2,37
Cyprinus carpio 'Furong' x Carassius auratus red var.,16581,13,22,2,37
Meloidogyne arenaria,17580,12,22,2,36
Meloidogyne enterolobii,17053,12,22,2,36
Meloidogyne javanica,18291,12,22,2,36
Triplophysa strauchii,16590,13,22,2,37
Phataginus tricuspis,16570,13,22,2,37
Manis javanica,16576,13,22,2,37
Leiopelma hochstetteri,17175,13,22,2,37
Cygnus cygnus,16724,13,22,2,37
Pseudoterranova azarasi,13954,12,22,2,36
Papilio glaucus,15306,13,22,2,37
Pseudoniphargus daviui,15157,13,22,2,37
Himantura dalyensis,17693,13,22,2,37
Centropyge multicolor,16791,13,22,2,37
Centropyge joculator,16778,13,22,2,37
Chlorophthalmus nigromarginatus,17663,13,23,2,38
Lanius isabellinus,16819,13,22,2,37
Ianthocincla ocellata,17828,13,22,2,37
Callithrix kuhlii,16500,13,22,2,37
Tanakia tanago,16584,13,22,2,37
Cobitis biwae,16642,13,22,2,37
Lefua nikkonis,16589,13,22,2,37
Nipponocypris temminckii,16615,13,22,2,37
Myriopathes japonica,17733,13,2,2,17
Schizothorax kozlovi,16585,13,22,2,37
Cornufer vitianus,17106,13,23,2,38
Luehdorfia chinensis,16028,13,22,2,37
Paragonimus westermani complex sp. type 1,14103,12,22,2,36
Cyclosa argenteoalba,14575,13,22,2,37
Meriones libycus,16341,13,22,2,37
Meriones meridianus,16376,13,22,2,37
Bufo stejnegeri,17939,13,22,2,37
Danio nigrofasciatus,16616,13,22,2,37
Prochilodus argenteus,16697,13,22,2,37
Prochilodus costatus,16699,13,22,2,37
Stylodipus telum,16696,13,22,2,37
Litoditis aff. marina PmI,13766,12,22,2,36
Litoditis aff. marina PmII,13855,12,22,2,36
Litoditis aff. marina PmIII,14481,12,22,2,36
Litoditis aff. marina PmIV,13909,12,22,2,36
Apteroperla tikumana,15564,13,22,2,37
Ramisyllis multicaudata,15748,13,22,2,37
Lobosphaera incisa,69997,34,27,3,64
Cygnus olor,16739,13,22,2,37
Oopsacas minuta,19042,14,22,2,38
Apolemichthys griffisi,16528,13,22,2,37
Botryococcus braunii,84583,42,23,3,68
Phycomyces blakesleeanus,62082,31,24,2,57
Balamuthia mandrillaris,42217,40,13,2,55
Crocidura attenuata,17534,13,22,2,37
Monoraphidium neglectum,93840,17,23,0,40
Pseudoperonospora cubensis,38553,39,25,2,66
Operophtera brumata,15748,13,22,2,37
Saccostrea cucullata,16396,12,23,3,38
Bactrocera zonata,15935,13,22,2,37
Gnathostoma spinigerum,14079,12,22,2,36
Micrura bella,16847,13,22,2,37
Arremon aurantiirostris,16785,13,22,2,37
Ephippus orbis,16670,13,22,2,37
Nemipterus virgatus,16992,13,22,2,37
Scorpaenopsis cirrosa,16966,13,22,2,37
Propithecus tattersalli,17099,13,22,2,37
Ancherythroculter lini,16616,13,22,2,37
Fukomys damarensis,16372,13,22,2,37
Perca schrenkii,16536,13,22,2,37
Sphaeroforma arctica JP610,43124,0,0,0,0
Trichosporon asahii var. asahii CBS 2479,32568,11,14,0,25
Acanthamoeba castellanii,41591,40,15,2,57
Papilio maraho,16094,13,22,2,37
Alouatta seniculus,16557,13,22,2,37
Mauremys caspica,16741,13,22,2,37
Odorrana schmackeri,18302,13,21,2,36
Mungotictis decemlineata,16910,13,22,2,37
Amynthas longisiphonus,15176,13,23,2,38
Amynthas corticis,15126,13,22,2,37
Spodoptera frugiperda,15365,13,22,2,37
Nestor notabilis,16818,13,22,2,37
Iksookimia koreensis,16563,13,22,2,37
Iksookimia longicorpa,16624,13,22,2,37
Nevromus exterior,15763,13,22,2,37
Neoneuromus tonkinensis,15776,13,22,2,37
Sinibotia robusta,16575,13,22,2,37
Lamellibrachia satsuma,15037,13,22,2,37
Tityus serrulatus,14460,13,21,2,36
Labeo gonius,16614,13,22,2,37
Apolemichthys armitagei,16551,13,22,2,37
Ginkgo biloba,346544,40,23,3,66
Fistulifera solaris,39476,36,24,2,62
Kudoa hexapunctata,18219,11,4,2,17
Crassostrea gasar,17685,12,24,4,40
Sanionia uncinata,104497,40,24,3,67
Blastocystis sp. subtype 4,27717,27,14,2,43
Chionoloma tenuirostre,105001,39,24,3,66
Kudoa septempunctata,19425,11,0,2,13
Eurystomus orientalis,17210,13,22,2,37
Hippocampus reidi,16529,13,22,2,37
Aegotheles cristatus,16914,13,22,2,37
Micromys minutus,16232,13,22,2,37
Motacilla cinerea,16835,13,22,2,37
Phoenicopterus ruber,17476,13,22,2,37
Vulpes ferrilata,16667,13,22,2,37
Dryobates pubescens,16840,13,22,2,37
Drosophila albomicans,15846,13,22,2,37
Aptenodytes forsteri,17301,13,22,2,37
Schizopyge nukiangensis,16585,13,22,2,37
Zosterops erythropleurus,17811,13,22,2,37
Argopecten purpuratus,16270,12,23,2,37
Microtus ochrogaster,16292,13,22,2,37
Maylandia zebra,16582,13,22,2,37
Jankowskia athleta,15534,13,22,2,37
Poecilia formosa,16542,13,22,2,37
Lutjanus peru,16502,13,22,2,37
Protomelas annectens,16583,13,22,2,37
Canis lupaster,16721,13,22,2,37
Explanatum explanatum,13968,12,22,2,36
Plodia interpunctella,15264,13,22,2,37
Sorex araneus,16887,13,23,2,38
Choloepus hoffmanni,16466,13,22,2,37
Symphysodon haraldi,16543,13,22,2,37
Genicanthus melanospilos,16736,13,22,2,37
Centropyge heraldi,16836,13,22,2,37
Centropyge woodheadi,16863,13,22,2,37
Centropyge flavissima,17010,13,22,2,37
Centropyge eibli,17101,13,22,2,37
Genicanthus lamarck,16616,13,22,2,37
Plecotus macrobullaris,16830,13,22,2,37
Fischoederius elongatus,14120,12,22,2,36
Naticarius hebraeus,15384,13,22,2,37
Galeodea echinophora,15388,13,22,2,37
Pundamilia nyererei,16761,13,22,2,37
Mustela eversmannii,16463,13,22,2,37
Pseudopleuronectes yokohamae,17383,13,22,2,37
Polypedilum vanderplanki,16445,13,22,2,37
Anopheles sinensis,15076,13,22,2,37
Salvelinus albus,16653,13,22,2,37
Sasia ochracea,16908,13,22,2,37
Campephilus guatemalensis,16856,13,22,2,37
Cleisthenes herzensteini,17175,13,22,2,37
Haemagogus janthinomys,15698,13,22,2,37
Conolophus subcristatus,16892,13,22,2,37
Amblyrhynchus cristatus,16897,13,22,2,37
Alticorpus geoffreyi,16578,13,22,2,37
Gekko japonicus,16544,13,22,2,37
Lonchura punctulata,16824,13,22,2,37
Castanozoster thoracicus,16772,13,22,2,37
Microspingus cabanisi,16768,13,22,2,37
Microspingus lateralis,16773,13,22,2,37
Phlebotomus chinensis,16277,13,22,2,37
Phlebotomus papatasi,15557,13,22,2,37
Ulva fasciata,61614,36,27,2,65
Hemigrammus bleheri,17021,13,22,2,37
Goura scheepmakeri,17131,13,22,2,37
Ptyas major,17217,13,22,2,37
Ptyas dhumnades,17164,13,22,2,37
Drawida japonica,14648,13,22,2,37
Epinephelus fuscoguttatus x Epinephelus lanceolatus,16644,13,22,2,37
Lucilia illustris,15954,13,22,2,37
Lucilia caesar,15954,13,22,2,37
Stenopelmatus fuscus,15767,13,22,2,37
Cyphoderris monstrosa,16590,13,22,2,37
Camptonotus carolinensis,15211,13,22,2,37
Pseudothericles compressifrons,15081,13,22,2,37
Comicus campestris,15691,13,21,2,36
Henicus brevimucronatus,15140,13,22,2,37
Mirhipipteryx andensis,15307,13,22,2,37
Orthocoelium streptocoelium,13800,12,22,2,36
Hypoptopoma incognitum,16630,13,22,2,37
Kamimuria chungnanshana,15943,13,22,2,37
Cyrtarachne nagasakiensis,14402,13,22,2,37
Hypsosinga pygmaea,14193,13,22,2,37
Taractes rubescens,16720,13,22,2,37
Garrulax poecilorhynchus,17814,13,22,2,37
Xiphophorus couchianus,16638,13,22,2,37
Nepa hoffmanni,15774,13,22,2,37
Sinergasilus polycolpus,14000,13,22,2,37
Herona marathus,15487,13,22,2,37
Pimephales promelas,16709,13,22,2,37
Cyprinodon variegatus,16500,13,22,2,37
Fossorochromis rostratus,16581,13,22,2,37
Glossolepis incisus,16529,13,22,2,37
Tricholoma matsutake,76037,24,28,2,54
Saccharina sp. ye-B,37657,38,24,3,65
Saccharina sp. ye-C12,37654,38,24,3,65
Vazella pourtalesii,20312,13,22,2,37
Peronospora tabacina,43225,47,25,2,74
Uropsilus sp. 4 FT-2015,16542,13,22,2,37
Ictalurus furcatus,16499,13,22,2,37
Daphnia carinata,15245,13,22,2,37
Drabescoides nuchalis,15309,13,22,2,37
Placidochromis longimanus,16581,13,22,2,37
Periophthalmus magnuspinnatus,16497,13,22,2,37
Phyllomimus detersus,16007,13,22,2,37
Ruidocollaris obscura,16424,13,22,2,37
Capra aegagrus,16625,13,22,2,37
Otus scops,17413,13,22,2,37
Otus bakkamoena,17389,13,22,2,37
Drepanidotaenia lanceolata,13573,12,22,2,36
Banjos banjos,16485,13,22,2,37
Maccullochella ikei,16437,13,22,2,37
Maccullochella macquariensis,16437,13,22,2,37
Atrijuglans hetaohei,15379,13,22,2,37
Bengana rendahli,16586,13,22,2,37
Megalobrama skolokovii x Megalobrama amblycephala,16621,13,22,2,37
Megalobrama amblycephala x Megalobrama skolkovii,16623,13,22,2,37
Dendrocopos major,16845,13,22,2,37
Silurus microdorsalis,16524,13,22,2,37
Sternula albifrons,16357,13,22,2,37
Halcyon coromanda,16542,13,22,2,37
Upupa epops,16562,13,22,2,37
Turdus rufiventris,16669,13,22,2,37
Hippocampus abdominalis,16521,13,22,2,37
Symphysodon aequifasciata,16545,13,22,2,37
Volutharpa perryi,15255,13,22,2,37
Batrachoseps nigriventris,17403,13,24,2,39
Garrulax sannio,17848,13,22,2,37
Parus monticolus,16771,13,22,2,37
Turdus merula,16733,13,22,2,37
Gorsachius magnificus,19212,14,25,2,41
Gorsachius goisagi,18562,13,22,2,37
Gorsachius melanolophus,18470,13,22,2,37
Megaphragma amalphitanum,15041,13,22,2,37
Serranidae sp. JL-2015,16512,13,22,2,37
Coregonus sp. 'cluncaformis',16736,13,22,2,37
Enchiridium sp. MTA_2015,14651,12,22,2,36
Hoploplana elisabelloi,15206,12,22,2,36
Prosthiostomum siphunculus,15181,12,22,2,36
Cryptolestes ferrugineus,15511,13,22,2,37
Cryptolestes pusillus,15502,13,22,2,37
Scartelaos gigas,16717,13,22,2,37
Acrossocheilus beijiangensis,16600,13,22,2,37
Junonia coenia,15222,13,22,2,37
Propithecus verreauxi,17106,13,22,2,37
Anopheles arabiensis,15369,13,22,2,37
Anopheles atroparvus,15458,13,22,2,37
Anopheles christyi,14967,13,22,2,37
Anopheles coluzzii,15441,13,22,2,37
Anopheles culicifacies,15364,13,22,2,37
Anopheles epiroticus,15379,13,22,2,37
Anopheles maculatus,14850,13,22,2,37
Anopheles melas,15366,13,22,2,37
Anopheles merus,15365,13,22,2,37
Anopheles minimus,15411,13,22,2,37
Anopheles punctulatus,15322,13,22,2,37
Anopheles stephensi,15387,13,22,2,37
Megalobrama amblycephala x Megalobrama pellegrini,16623,13,22,2,37
Portunus sanguinolentus,16024,13,22,2,37
Delia antiqua,16141,13,22,2,37
Sillago japonica,16645,13,22,2,37
Strongyloides venezuelensis,15956,12,21,2,35
Turdus eunomus,16737,13,22,2,37
Gambusia holbrooki,16611,13,22,2,37
Alosa alabamae,16708,13,22,2,37
Noturus taylori,16492,13,22,2,37
Cottus bairdii,16529,13,22,2,37
Notophthalmus perstriatus,16336,13,22,2,37
Paracheirodon innesi,16759,13,22,2,37
Melanotaenia splendida,16528,13,22,2,37
Limanda aspera,17194,13,22,2,37
Umbra limi,16795,13,22,2,37
Lithobates okaloosae,17504,13,22,2,37
Lepomis gibbosus,16503,13,22,2,37
Sander vitreus,16858,13,22,2,37
Pseudanthias dispar,16954,13,22,2,37
Centropyge bispinosa,16772,13,22,2,37
Eucyclogobius newberryi,16523,13,22,2,37
Macropharyngodon negrosensis,16889,13,22,2,37
Acipenser oxyrinchus,16565,13,22,2,37
Meda fulgida,16591,13,22,2,37
Cyprinodon tularosa,16501,13,22,2,37
Fundulus notatus,16510,13,22,2,37
Poeciliopsis occidentalis,16771,13,22,2,37
Ecsenius bicolor,16534,13,22,2,37
Rana draytonii,17805,13,22,2,37
Gyrinophilus palleucus,16737,13,22,2,37
Pomoxis nigromaculatus,16496,13,22,2,37
Profelis aurata,16826,13,22,2,37
Catopuma badia,16693,13,22,2,37
Prionailurus bengalensis,16701,13,22,2,37
Panthera leo,16620,13,22,2,37
Pardofelis marmorata,16827,13,22,2,37
Prionailurus rubiginosus,16832,13,22,2,37
Prionailurus viverrinus,16723,13,22,2,37
Caracal caracal,16859,13,22,2,37
Felis chaus,16653,13,22,2,37
Felis margarita,16864,13,22,2,37
Felis nigripes,16723,13,22,2,37
Felis silvestris,16640,13,22,2,37
Puma yagouaroundi,16700,13,22,2,37
Lynx canadensis,16666,13,22,2,37
Leopardus colocolo,16650,13,22,2,37
Leopardus pardalis,16712,13,22,2,37
Leptailurus serval,16708,13,22,2,37
Leopardus tigrinus,16767,13,22,2,37
Leopardus wiedii,16704,13,22,2,37
Lynx pardinus,16806,13,22,2,37
Leopardus geoffroyi,16738,13,22,2,37
Leopardus guigna,16773,13,22,2,37
Leopardus jacobita,16610,13,22,2,37
Otocolobus manul,16626,13,22,2,37
Junonia lemonias,15230,13,22,2,37
Himantura uarnak,17690,13,22,2,37
Paroedura picta,17220,13,22,2,37
Bactrocera arecae,15900,13,22,2,37
Agasicles hygrophila,15917,13,22,2,37
Lanius cristatus,16821,13,22,2,37
Pseudanoplocephala crawfordi,14192,12,22,2,36
Bandicota indica,16326,13,22,2,37
Glyphis sp. Pakistan,16706,13,22,2,37
Glyphis gangeticus,16706,13,22,2,37
Glyphis sp. Borneo,16707,13,22,2,37
Lamiopsis tephrodes,16705,13,22,2,37
Lamiopsis temminckii,16708,13,22,2,37
Glyphis fowlerae,16704,13,22,2,37
Glyphis sp. Bangladesh,16707,13,22,2,37
Glyphis siamensis,16690,13,22,2,37
Spatula clypeata,16599,13,22,2,37
Hepialus xiaojinensis,15397,13,22,2,37
Prionailurus planiceps,16709,13,22,2,37
Sagmariasus verreauxi,15470,13,22,2,37
Anodonta anatina,15653,14,22,2,38
Lamproptera curius,15277,13,22,2,37
Nilaparvata muiri,14371,13,22,2,37
Ovis orientalis,16617,13,22,2,37
Ovis vignei,16697,13,22,2,37
Radix auricularia,13745,13,22,2,37
Physella acuta,14490,13,22,2,37
Ulva prolifera,63845,43,29,2,74
Skeletonema marinoi,38515,35,25,2,62
Plasmodium vivax,5882,3,0,0,3
Trichopodus leerii,16454,13,22,2,37
Pneumocystis carinii,26119,17,25,2,44
Garra qiaojiensis,17096,13,22,2,37
Acipenser medirostris,16611,13,22,2,37
Epinephelus malabaricus,16423,13,22,2,37
Cypridopsis vidua,16783,13,22,2,37
Gallicrex cinerea,17184,13,22,2,37
Calliphora vomitoria,16134,13,22,2,37
Chrysomya nigripes,15832,13,22,2,37
Sarcophaga albiceps,14935,13,22,2,37
Cuculus poliocephalus,17508,13,22,2,37
Acheilognathus gracilis,16988,13,22,2,37
Cyprinus megalophthalmus,16580,13,22,2,37
Cyprinus acutidorsalis,16580,13,22,2,37
Cyprinus multitaeniata,16580,13,22,2,37
Seriolina nigrofasciata,16531,13,22,2,37
Bodianus oxycephalus,16514,13,22,2,37
Strauchbufo raddei,17602,13,22,2,37
Anoplocephala perfoliata,14459,12,22,2,36
Garra kempi,17104,13,22,2,37
Lycaon pictus,16173,13,22,2,37
Epinephelus bontoides,16903,13,22,2,37
Tridentiger obscurus,16503,13,22,2,37
Gymnogobius urotaenia,16430,13,22,2,37
Acheilognathus rhombeus,16780,13,22,2,37
Pseudobagrus koreanus,16532,13,22,2,37
Rhinogobius brunneus,16500,13,22,2,37
Paradoxornis fulvifrons,17059,13,22,2,37
Suthora nipalensis,16996,13,22,2,37
Aldabrachelys gigantea,16467,13,22,2,37
Lacerta bilineata,17086,13,22,2,37
Padda oryzivora,16817,13,22,2,37
Mandrillus leucophaeus,16547,13,22,2,37
Amyelois transitella,15205,13,22,2,37
Calameuta filiformis,20055,13,22,2,37
Calameuta idolon,19746,13,22,2,37
Davidina armandi,15214,13,22,2,37
Heteropterus morpheus,15769,13,22,2,37
Lethe albolineata,15248,13,24,2,39
Creteuchiloglanis macropterus,16592,13,22,2,37
Austrolebias charrua,17271,13,22,2,37
Oreoglanis immaculatus,16576,13,22,2,37
Oreoglanis jingdongensis,16569,13,22,2,37
Pareuchiloglanis anteanalis,16554,13,22,2,37
Pareuchiloglanis longicauda,16535,13,22,2,37
Pareuchiloglanis macrotrema,16570,13,22,2,37
Creteuchiloglanis gongshanensis,16586,13,22,2,37
Rana huanrensis,19253,13,22,2,37
Potamilus leptodon,16133,13,22,2,37
Danio margaritatus,16620,13,22,2,37
Acrossocheilus yunnanensis,16588,13,22,2,37
Dermacentor nuttalli,15086,13,22,2,37
Ammodytes dubius,16519,13,22,2,37
Ammodytes americanus,16519,13,22,2,37
Galleria mellonella,15320,13,22,2,37
Rhinolophus rex,16845,13,22,2,37
Squalus montalbani,16555,13,22,2,37
Heliothis subflexa,15323,13,22,2,37
Cynoglossus gracilis,16565,13,22,2,37
Gymnodiptychus dybowskii,16677,13,22,2,37
Zacco acanthogenys,16611,13,22,2,37
Octopus bimaculatus,16084,13,23,2,38
Pyrinioides aurea,15362,13,22,2,37
Scombrops gilberti,16518,13,22,2,37
Tetraodon lineatus,16459,13,22,2,37
Coregonus muksun,16736,13,22,2,37
Opsariichthys acutipinnis,16615,13,22,2,37
Candidia pingtungensis,16612,13,22,2,37
Atrecus affinis,16844,13,22,2,37
Callicerus obscurus,16954,13,22,2,37
Dacrila fallax,16802,13,22,2,37
Euryusa optabilis,17577,13,22,2,37
Gabronthus thermarum,16434,13,22,2,37
Liogluta microptera,17281,13,22,2,37
Margarinotus merdarius,16169,13,22,2,37
Myrmecocephalus concinnus,17278,13,22,2,37
Olophrum piceum,15676,13,22,2,37
Oxypoda acuminata,17075,13,22,2,37
Phacomorphus fratyi,15511,13,22,2,37
Rugilus geniculatus,17640,13,22,2,37
Scaphidium quadrimaculatum,18832,13,22,2,37
Sciodrepoides watsoni,18644,13,22,2,37
Sepedophilus bipunctatus,18985,13,22,2,37
Sphaeridium bipustulatum,16576,13,22,2,37
Tetartopeus terminatus,17652,13,22,2,37
Culex tritaeniorhynchus,15123,13,22,2,37
Teleogryllus oceanicus,15660,13,22,2,37
Strongyloides stercoralis,13751,12,21,2,35
Panulirus versicolor,15767,13,22,2,37
Babylonia lutosa,15346,13,22,2,37
Hexagrammos otakii,16513,13,22,2,37
Castor fiber,16722,12,22,2,36
Strongyloides ratti,16609,12,21,2,35
Trichuris muris,14105,13,22,2,37
Parastrongyloides trichosuri,13699,11,22,2,35
Strongyloides papillosus,13909,11,23,2,36
Chaetura pelagica,16896,13,23,2,38
Cercocebus atys,16543,13,22,2,37
Viscum album,565432,12,6,1,19
Pygoscelis adeliae,17486,13,22,2,37
Bos gaurus,16345,13,22,2,37
Mazama nemorivaga,16361,13,22,2,37
Dama mesopotamica,16355,13,22,2,37
Welwitschia mirabilis,978846,29,8,3,40
Lepidochelys olivacea,16718,13,22,2,37
Limnoperna fortunei,18145,12,24,2,38
Angaria neglecta,19470,13,22,2,37
Granata lyrata,17632,13,22,2,37
Chaetopterus variopedatus,16143,13,23,2,38
Magelona mirabilis,15239,13,22,2,37
Owenia fusiformis,16204,13,22,2,37
Eurythoe complanata,15829,13,23,2,38
Centropyge flavicauda,16747,13,22,2,37
Centropyge acanthops,16748,13,22,2,37
Coptotermes testaceus,15752,13,22,2,37
Pterophyllum altum,16495,13,22,2,37
Tyrophagus longior,13271,13,19,2,34
Lycodon flavozonatus,17172,13,22,2,37
Sepiella maindroni,16170,13,22,2,37
Rhizophagus fasciculatus,72251,30,25,2,57
Verticillium nonalfalfae,26139,15,26,3,44
Fusarium mangiferae,30629,18,9,1,28
Acheilognathus majusculus,17155,13,25,3,41
Orthotrichum macrocephalum,104624,40,24,3,67
Orthotrichum diaphanum,104744,40,24,3,67
Didymella pinodes,55973,11,23,2,36
Phytophthora polonica,40467,41,25,2,68
Racomitrium lanuginosum,106795,42,24,3,69
Salix suchowensis,644437,33,22,3,58
Peripolus nepalensis,15858,13,22,2,37
Parnara guttata,15441,13,22,2,37
Gryllotalpa unispina,15513,13,22,2,37
Hampala macrolepidota,16766,13,22,2,37
Locustella pryeri,17968,13,22,2,37
Pampus cinereus,16554,13,22,2,37
Tetraclita serrata,15200,13,22,2,37
Aleurocanthus spiniferus,15220,13,21,2,36
Salanx cuvieri,16588,13,22,2,37
Hemisalanx brachyrostralis,16588,13,22,2,37
Ictalurus pricei,16503,13,22,2,37
Ictalurus cf. pricei USON-01115-1,16503,13,22,2,37
Ictalurus cf. pricei USON-01120-1,16503,13,22,2,37
Gynaephora aureata,15773,13,22,2,37
Gynaephora qinghaiensis,15747,13,22,2,37
Gynaephora qumalaiensis,15753,13,22,2,37
Protobothrops himalayanus,17389,13,22,2,37
Protobothrops kaulbacki,17237,13,22,2,37
Armatobalanus allium,15063,13,22,2,37
Acasta sulcata,15326,13,22,2,37
Chelonibia testudinaria,14906,13,22,2,37
Tetraclitella divisa,14973,13,22,2,37
Platypharodon extremus,16668,13,22,2,37
Lachana alpherakii,15755,13,22,2,37
Chuanchia labiosa,16705,13,22,2,37
Mauremys rivulata,16766,13,22,2,37
Selaroides leptolepis,16560,13,22,2,37
Phrynocephalus albolineatus,16808,13,22,2,37
Gobiobotia filifer,16613,13,22,2,37
Aquila fasciata,18513,13,22,2,37
Buteo lagopus,18559,13,22,2,37
Schizopygopsis anteroventris,16620,13,22,2,37
Pipistrellus coromandra,17153,13,22,2,37
Epicauta chinensis,15717,13,22,2,37
Caesio cuning,16508,13,22,2,37
Pelophylax cf. bedriagae AFL1,17977,13,22,2,37
Pelophylax cf. bedriagae MPFC1082,17975,13,22,2,37
Pelophylax cf. terentievi GM87-239,17987,13,22,2,37
Pelophylax cf. terentievi MPFC1736,17990,13,22,2,37
Pelophylax bedriagae,17968,13,22,2,37
Pelophylax cf. bedriagae GM178,17932,13,22,2,37
Gonista bicolor,15618,13,22,2,37
Epitrimerus sabinae,13531,13,22,2,37
Phyllocoptes taishanensis,13475,13,22,2,37
Aculamprotula tientsinensis,15695,14,22,2,38
Calliphora chinghaiensis,15269,13,22,2,37
Thymallus mertensii,16662,13,22,0,35
Xenoturbella churro,15339,13,22,2,37
Xenoturbella hollandorum,15210,13,22,2,37
Xenoturbella monstrosa,15279,13,22,2,37
Xenoturbella profunda,15403,13,22,2,37
Priacanthus macracanthus,17003,13,22,2,37
Paralichthys lethostigma,16843,13,22,2,37
Blaptica dubia,17340,13,22,2,37
Opisthoplatia orientalis,18724,13,22,2,37
Longpotamon xiushuiense,18460,13,22,2,37
Amblychaeturichthys hexanema,18562,13,22,2,37
Motacilla alba,16826,13,22,2,37
Anoplophora chinensis,15805,13,22,2,37
Tylototriton kweichowensis,16727,13,22,2,37
Allodiplogaster sudhausi,16005,12,22,2,36
Yongeichthys criniger,16627,13,22,2,37
Paracanthurus hepatus,16498,13,22,2,37
Palaemon gravieri,15740,13,22,2,37
Claea dabryi,16569,13,22,2,37
Papilio xuthus,15359,13,22,2,37
Rodentolepis nana,13764,12,22,2,36
Hydropsyche pellucidula,25004,13,22,2,37
Parupeneus chrysopleuron,17397,13,23,2,38
Pteronarcella badia,15585,13,22,2,37
Toxabramis swinhonis,16622,13,22,2,37
Amolops loloensis,18926,13,22,2,37
Rhinogobius cliffordpopei,16525,13,22,2,37
Eremothecium sinecaudum,26238,8,22,2,32
Medicago truncatula,271618,31,16,3,50
Trachydiscus minutus,45831,46,27,3,76
Lobesia botrana,15229,13,22,2,37
Redigobius bikolanus,16464,13,22,2,37
Spizixos semitorques,17045,13,22,2,37
Pseudorhombus dupliciocellatus,16621,13,22,2,37
Okamejei hollandi,16974,13,22,2,37
Tamiops maritimus,16523,13,22,2,37
Hierodula formosana,16266,13,22,2,37
Oedaleus infernalis,15898,13,22,2,37
Synthliboramphus wumizusume,16714,13,22,2,37
Crocidura lasiura,17364,13,22,2,37
Triplophysa venusta,16574,13,22,2,37
Callipepla squamata,16701,13,22,2,37
Phoxinus semotilus,16605,13,22,2,37
Myotis bombinus,17128,13,22,2,37
Pictichromis paccagnellae,16976,13,22,2,37
Passer ammodendri,16782,13,22,2,37
Pachytriton feii,16293,13,22,2,37
Myotis myotis,17213,13,22,2,37
Toxabramis houdemeri,16618,13,22,2,37
Hippocampus kelloggi,16536,13,22,2,37
Hippocampus spinosissimus,16530,13,22,2,37
Falco rusticolus,18218,13,22,2,37
Sturnus vulgaris,16793,13,22,2,37
Moloha majora,15903,13,22,2,37
Bolma rugosa,17432,13,22,2,37
Tegula lividomaculata,17375,13,20,2,35
Periophthalmus argentilineatus,16509,13,22,2,37
Mauremys nigricans,16779,13,22,2,37
Rhynchocinetes durbanensis,17695,13,24,2,39
Buccinum pemphigus,15265,13,22,2,37
Epomophorus gambianus,16702,13,22,2,37
Lagocephalus inermis,16493,13,22,2,37
Buteo hemilasius,18079,13,22,2,37
Aulonocara stuartgranti,16669,13,22,2,37
Tlacuatzin canescens,16460,13,22,2,37
Zebrias crossolepis,16775,13,22,2,37
Larus vegae,16379,13,22,2,37
Ninox scutulata,16208,13,22,2,37
Lefua costata,16579,13,22,2,37
Tecia solanivora,15251,13,22,2,37
Squalidus multimaculatus,16597,13,22,2,37
Hemiculter eigenmanni,16626,13,22,2,37
Priacanthus tayenus,16866,13,22,2,37
Engaewa walpolea,15984,13,22,2,37
Cephaloscyllium umbratile,16698,13,22,2,37
Hemigaleus microstoma,16701,13,22,2,37
Trochalopteron affine,17856,13,22,2,37
Paguma larvata,16710,13,22,2,37
Geotria australis,17080,13,22,2,37
Taenioides anguillaris,16974,13,22,2,37
Engaewa subcoerulea,16001,13,22,2,37
Compsorhipis davidiana,16085,13,22,2,37
Kaloula rugifera,17074,13,22,2,37
Hyla ussuriensis,18023,13,22,2,37
Caranx tille,16593,13,22,2,37
Myotis muricola,17224,13,22,2,37
Gloydius shedaoensis,17222,13,22,2,37
Leuciscus oxyrrhis,16607,13,22,2,37
Leuciscus burdigalensis,16607,13,22,2,37
Telchinia bonasia,15290,13,22,0,35
Acraea rogersi,15274,13,22,0,35
Acraea poggei,15361,13,22,0,35
Telchinia penelope,15271,13,22,0,35
Telchinia perenna,15315,13,22,0,35
Telchinia lycoa,15190,13,22,0,35
Telchinia polis,15254,13,22,0,35
Telchinia serena,15258,13,22,0,35
Acraea alcinoe,15729,13,22,0,35
Telchinia parrhasia,15261,13,22,0,35
Acraea vestalis,15350,13,22,0,35
Telchinia kalinzu,15260,13,22,0,35
Spiniphilus spinicornis,15707,13,22,2,37
Plestiodon chinensis,17175,13,22,2,37
Dixella aestivalis,16465,13,22,2,37
Aegista aubryana,14238,13,22,2,37
Triplophysa dorsalis,16572,13,22,2,37
Schistura geisleri,16819,13,22,2,37
Labeo altivelis,16603,13,22,2,37
Lepidodesma languilati,15754,13,22,2,37
Triplophysa xiangxiensis,16598,13,22,2,37
Nebrius ferrugineus,16693,13,22,2,37
Trimeresurus sichuanensis,17225,13,22,2,37
Hormaphis betulae,15088,13,22,2,37
Telchinia jodutta,15272,13,22,0,35
Acraea egina,15405,13,22,0,35
Telchinia acerata,15281,13,22,0,35
Acraea zetes,15228,13,22,0,35
Telchinia circeis,15235,13,22,0,35
Telchinia pharsalus,15224,13,22,0,35
Crossocheilus atrilimes,16586,13,22,2,37
Sphyraena jello,16699,13,22,2,37
Yuhina diademata,17834,13,22,2,37
Bactrocera latifrons,15977,13,22,2,37
Bactrocera melastomatos,15954,13,22,2,37
Bactrocera umbrosa,15898,13,22,2,37
Pungitius hellenicus,16713,13,22,2,37
Pungitius tymensis,16481,13,22,2,37
Pungitius laevis,16576,13,22,2,37
Lonchura striata,16813,13,22,2,37
Paralichthys dentatus,17033,13,22,2,37
Myodes rufocanus,16487,13,22,2,37
Evynnis tumifrons,16616,13,22,2,37
Stegostoma fasciatum,16658,13,22,2,37
Fascioloides magna,14047,12,22,2,36
Campylorhynchus brunneicapillus,16786,13,22,2,37
Lucilia coeruleiviridis,14989,13,22,2,37
Muscina levida,14909,13,21,2,36
Uraspis secunda,16554,13,22,2,37
Scolopsis vosmeri,16770,13,22,2,37
Acrossocheilus paradoxus,16597,13,22,2,37
Parapocryptes serperaster,17243,13,22,2,37
Metapenaeopsis dalei,15939,13,22,2,37
Pungitius platygaster,16570,13,22,2,37
Lotharella oceanica,36702,35,24,3,62
Pyronema omphalodes,191189,48,26,2,76
Salix purpurea,598970,32,21,3,56
Ulva linza,70858,28,22,2,52
Colletotrichum tamarilloi,30824,15,29,2,46
Cairneyella variabilis,27186,16,25,1,42
Nicotiana sylvestris,430597,37,23,4,64
Oryza minuta,515022,59,31,2,92
Ziziphus jujuba,365190,35,19,2,56
Lucilia sericata,15945,13,22,2,37
Corallianassa coutierei,15481,13,22,2,37
Nihonotrypaea japonica,15274,13,22,2,37
Macrobrachium lanchesteri,15694,13,22,2,37
Caridina gracilipes,15550,13,22,2,37
Conus tribblei,15570,13,22,2,37
Pythium insidiosum,54989,59,40,4,103
Metorchis orientalis,13834,12,22,2,36
Tetragnatha nitens,14639,13,22,2,37
Aperioptus gracilentus,16603,13,23,2,38
Osteochilus hasseltii,16537,13,22,2,37
Porites lutea,18646,13,8,2,23
Galaxea fascicularis,18751,13,3,2,18
Apostichopus parvimensis,16120,13,22,2,37
Amphioctopus aegina,15545,13,22,2,37
Motacilla lugens,16834,13,22,2,37
Ancherythroculter kurematsui,16621,13,22,2,37
Schizothorax grahami,16584,13,22,2,37
Glyptothorax zanaensis,16537,13,22,2,37
Polynemus dubius,16555,13,22,2,37
Plotosus lineatus,16480,13,22,2,37
Lepisosteus platyrhincus,16320,13,22,2,37
Rhodeus notatus,16735,13,22,2,37
Faxonius rusticus,15875,13,22,2,37
Orconectes sanbornii,15883,13,22,2,37
Chanodichthys ilishaeformis,16624,13,22,2,37
Octopus bimaculoides,15733,13,22,2,37
Ocypode cordimanus,15604,13,22,2,37
Leptodius sanguineus,15480,13,22,2,37
Myzus persicae,17382,13,22,2,37
Cheilopogon unicolor,16529,13,22,2,37
Cheilopogon arcticeps,16530,13,22,2,37
Cheilopogon atrisignis,16530,13,22,2,37
Haemonchus placei,13664,12,22,2,36
Chionodraco hamatus,17457,13,22,2,37
Tridentiger trigonocephalus,16673,13,22,2,37
Galaxias platei,16502,13,22,2,37
Mylochromis lateristriga,16576,13,22,2,37
Nemateleotris decora,16502,13,22,2,37
Octopus conispadiceus,16027,13,22,2,37
Pseudargyria interruptella,15231,13,22,2,37
Megalobrama terminalis x Megalobrama amblycephala,16622,13,22,2,37
Simulium aureohirtum,15904,13,22,2,37
Fejervarya multistriata,17750,13,22,2,37
Neoscona nautica,14049,13,22,2,37
Neoscona adianta,14161,13,22,2,37
Brachycladium goliath,15229,12,22,2,36
Phalacrocorax brasilianus,19042,14,25,2,41
Copadichromis virginalis,16704,13,22,2,37
Shijimiaeoides divina,15259,13,22,2,37
Polyacanthorhynchus caballeroi,13956,12,22,2,36
Plagiorhynchus transversus,15477,12,22,2,36
Pomatorhinus ruficollis,17009,13,22,2,37
Danio albolineatus,16610,13,22,2,37
Cannabis sativa,415602,35,15,3,53
Cobitis matsubarai,16574,13,22,2,37
Tariqlabeo bicornis,16710,13,22,2,37
Labeo pangusia,16601,13,22,2,37
Muricea purpurea,19358,14,1,2,17
Tariqilabeo burmanicus,16710,13,22,2,37
Labeo boggut,16603,13,22,2,37
Crossocheilus langei,16569,13,22,2,37
Labeo nasus,16601,13,22,2,37
Cirrhinus reba,16597,13,22,2,37
Luciocyprinus striolatus,16601,13,22,2,37
Pseudogastromyzon myersi,16562,13,22,2,37
Bhavania australis,16562,13,22,2,37
Populus tremula,783442,33,22,3,58
Tetraplodon fuegianus,104741,40,24,3,67
Lecanicillium saksenae,25919,15,26,2,43
Turnagra capensis,16994,13,22,2,37
Passalurus ambiguus,14023,12,22,2,36
Procambarus alleni,15942,13,22,2,37
Colletotrichum lindemuthianum,36957,16,28,1,45
Colletotrichum acutatum,30892,15,28,2,45
Melanotaenia boesemani,16493,13,22,2,37
Bradypus variegatus,16641,13,22,2,37
Sphyrna tiburo,16723,13,22,2,37
Limonius californicus,16467,13,22,2,37
Dichomeris ustalella,15410,13,22,2,37
Mesophleps albilinella,15274,13,22,2,37
Gasterophilus pecorum,15750,13,22,2,37
Lerema accius,15338,13,22,2,37
Hemiculter bleekeri,16615,13,22,2,37
Etroplus suratensis,16467,13,22,2,37
Mogera robusta,16816,13,22,2,37
Regulus regulus,16847,13,22,2,37
Heterakis beramporia,14012,12,22,2,36
Heterakis gallinarum,13973,12,22,2,36
Episoriculus macrurus,16943,13,22,2,37
Pholis nebulosa,16524,13,22,2,37
Pholis fangi,16523,13,22,2,37
Loxodon macrorhinus,16702,13,22,2,37
Helcystogramma macroscopa,15394,13,22,2,37
Cubiceps squamiceps,16510,13,22,2,37
Myotis lucifugus,17038,13,22,2,37
Dendrocopos leucotos,16838,13,22,2,37
Amynthas carnosus,15160,13,22,2,37
Amynthas hupeiensis,15069,13,22,2,37
Amynthas morrisi,15026,13,22,2,37
Amynthas cucullatus,15122,13,22,2,37
Duplodicodrilus schmardae,15156,13,22,2,37
Amynthas triastriatus,15160,13,22,2,37
Metaphire guillelmi,15174,13,22,2,37
Amynthas pectiniferus,15188,13,22,2,37
Amynthas robustus,15013,13,22,2,37
Amynthas moniliatus,15133,13,22,2,37
Endoclita signifer,15285,13,22,2,37
Nibea miichthioides,16490,13,22,2,37
Dactylomys dactylinus,16650,13,22,2,37
Salvelinus kuznetzovi,16654,13,22,2,37
Eremias stummeri,19602,13,22,2,37
Amynthas jiriensis,15151,13,22,2,37
Elagatis bipinnulata,16542,13,22,2,37
Oligolophus tienmushanensis,16798,13,22,2,37
Rattus tiomanicus,16309,13,22,2,37
Galaxias truttaceus,16510,13,22,2,37
Nemipterus bathybius,17353,13,22,2,37
Hypsugo alaschanicus,17300,13,22,2,37
Thryssa kammalensis,16968,13,22,2,37
Macropodus erythropterus,16495,13,22,2,37
Dirofilaria repens,13675,12,22,2,36
Naesiotus nux,15197,14,22,2,38
Bradypus pygmaeus,16799,13,22,2,37
Bradypus torquatus,16714,13,22,2,37
Cabassous centralis,17114,13,22,2,37
Cabassous chacoensis,16280,13,22,2,37
Cabassous tatouay,16638,13,22,2,37
Cabassous unicinctus,16397,13,22,2,37
Calyptophractus retusus,16231,13,22,2,37
Chaetophractus vellerosus,16598,13,22,2,37
Chaetophractus villosus,16796,13,22,2,37
Chlamyphorus truncatus,16245,13,22,2,37
Cyclopes didactylus,16368,13,22,2,37
Dasypus hybridus,17013,13,22,2,37
Dasypus kappleri,16636,13,22,2,37
Dasypus pilosus,17050,13,22,2,37
Dasypus sabanicola,16936,13,22,2,37
Dasypus septemcinctus,16683,13,22,2,37
Dasypus yepesi,16917,13,22,2,37
Euphractus sexcinctus,16602,13,22,2,37
Myrmecophaga tridactyla,16498,13,22,2,37
Priodontes maximus,16492,13,22,2,37
Tamandua mexicana,16385,13,22,2,37
Tolypeutes matacus,16980,13,22,2,37
Tolypeutes tricinctus,17161,13,22,2,37
Zaedyus pichiy,16598,13,22,2,37
Lecanora strobilina,39842,13,18,2,33
Colletotrichum fioriniae,30020,15,29,1,45
Allium cepa,316363,26,15,3,44
Metanephrops sibogae,20677,13,22,2,37
Conus tulipa,15756,13,22,2,37
Clarias gariepinus,16508,13,22,2,37
Gastrothylax crumenifer,14801,12,22,2,36
Populus tremula x Populus alba,783513,32,22,3,57
Anthus novaeseelandiae,16851,13,22,2,37
Poodytes punctatus,17973,13,22,2,37
Gerygone igata,16871,13,22,2,37
Notiomystis cincta,18645,14,24,2,40
Petroica australis,16912,13,22,2,37
Petroica macrocephala,16861,13,22,2,37
Philesturnus carunculatus,16827,13,22,2,37
Prosthemadera novaeseelandiae,16849,13,22,2,37
Rhipidura fuliginosa,16886,13,22,2,37
Zosterops lateralis,17821,13,22,2,37
Turdus philomelos,18540,14,24,2,40
Plasmodium chabaudi chabaudi,5949,3,0,33,36
Penicillium polonicum,28192,15,27,2,44
Porphyra purpurea,36753,29,24,2,55
Hypomyces aurantius,71638,44,25,2,71
Atylotus miser,15858,13,22,2,37
Gromphadorhina portentosa,15992,13,22,2,37
Panchlora nivea,16034,13,22,2,37
Shelfordella lateralis,15601,13,22,2,37
Chromodoris quadricolor,14259,13,22,2,37
Ostracion rhinorhynchos,16483,13,22,2,37
Makaira nigricans,16533,13,22,2,37
Tetrapturus pfluegeri,16508,13,22,2,37
Tetrapturus belone,16509,13,22,2,37
Tetrapturus georgii,16500,13,22,2,37
Kajikia albida,16528,13,22,2,37
Coptotermes amanii,14894,13,22,2,37
Coptotermes elisae,14900,13,22,2,37
Coptotermes frenchi,14912,13,22,2,37
Coptotermes gestroi,14919,13,22,2,37
Coptotermes heimi,14908,13,22,2,37
Coptotermes kalshoveni,14888,13,22,2,37
Coptotermes michaelseni,14900,13,22,2,37
Coptotermes sepangensis,14716,13,22,3,38
Coptotermes sjoestedti,14897,13,22,2,37
Coptotermes travians,14894,13,22,2,37
Heterotermes crinitus,14882,13,22,2,37
Heterotermes platycephalus,14919,13,22,2,37
Heterotermes tenuior,14916,13,22,2,37
Heterotermes tenuis,14940,13,22,2,37
Heterotermes vagus,14904,13,22,2,37
Reticulitermes grassei,14910,13,22,2,37
Reticulitermes nelsonae,14630,13,22,2,37
Rhinotermes hispidus,15057,13,22,2,37
Phyllidia ocellata,14598,13,22,2,37
Namalycastis abiuma,15265,13,20,2,35
Ptyas mucosa,17151,13,22,2,37
Rana amurensis,18470,13,22,2,37
Cimex lectularius,15217,13,23,2,38
Pyrhila pisum,15516,13,22,2,37
Macrophthalmus japonicus,16170,13,22,2,37
Microhyla butleri,16722,13,22,2,37
Gyrodactylus kobayashii,14786,12,22,2,36
Anomaloglossus baeobatrachus,17572,13,22,2,37
Bactericera cockerelli,15220,13,22,2,37
Cephalopholis urodeta,16592,13,22,2,37
Hapsodrilus ignifer,16072,13,22,2,37
Pyrearinus termitilluminans,16007,13,22,2,37
Bicellonychia lividipennis,16466,13,22,2,37
Lariscus insignis,16355,13,22,2,37
Callosciurus adamsi,15613,13,22,2,37
Exilisciurus exilis,16337,13,22,2,37
Caryanda sp. ZH-2016,15445,13,22,2,37
Melanotaenia australis,16530,13,22,2,37
Arctotherium sp.,16532,13,22,2,37
Vollenhovia emeryi,16259,13,22,2,37
Capricornis sp. YZ-2016,16441,13,22,2,37
Protobothrops tokarensis,17233,13,22,2,37
Ginglymostoma cirratum,16692,13,22,2,37
Achatinella mustelina,16323,13,22,2,37
Cryptocercus kyebangensis,15720,13,22,2,37
Pyrgus maculatus,15346,13,22,2,37
Sesarmops sinensis,15905,13,22,2,37
Helice tientsinensis,16212,13,22,2,37
Takydromus amurensis,17333,13,22,2,37
Rhabdophis tigrinus,17415,13,22,2,37
Glandirana emeljanovi,17733,13,22,2,37
Conus gloriamaris,15774,13,22,2,37
Diaphorina citri,14996,13,22,2,37
Rhina ancylostoma,17217,13,22,2,37
Proscyllium habereri,16708,13,22,2,37
Elusor macrurus,16499,13,22,2,37
Crassostrea iredalei,22446,12,23,4,39
Coregonus chadary,16739,13,22,2,37
Protobothrops flavoviridis,17232,13,22,2,37
Laonastes aenigmamus,16364,13,22,2,37
Porites lobata,18647,13,2,2,17
Mystus cavasius,16554,13,22,2,37
Horabagrus brachysoma,16567,13,22,2,37
Humbertiella nada,15866,13,22,2,37
Anaxarcha zhengi,16620,13,22,2,37
Epinephelus moara x Epinephelus lanceolatus,16866,13,22,2,37
Polystoechotes punctata,16036,13,22,2,37
Cetonurus globiceps,17137,13,22,2,37
Anopheles quadrimaculatus A,15455,13,22,2,37
Trypaea australiensis,15485,13,22,2,37
Taeniogonalos taihorina,15927,13,22,2,37
Onychomys leucogaster,16370,13,22,2,37
Rondotia menciana,15301,13,22,2,37
Lygus lineolaris,17027,13,22,2,37
Drosophila incompta,15640,13,22,2,37
Hemidactylus bowringii,17097,13,22,2,37
Saurida wanieso,16552,13,22,2,37
Lagocephalus spadiceus,16508,13,22,2,37
Cherax bicarinatus,16099,13,23,2,38
Pygoplites diacanthus,16313,13,22,2,37
Gekko chinensis,17906,13,22,2,37
Lithobates sylvaticus,17343,13,22,2,37
Hydropotes inermis,16355,13,22,2,37
Oncicola luehei,14281,12,22,2,36
Trichiurus lepturus nanhaiensis,17060,13,21,2,36
Leuciscus waleckii,16605,13,22,2,37
Aphyocypris moltrechti,16617,13,22,2,37
Cnemaspis limi,16680,13,22,2,37
Bufo tibetanus,17405,13,22,2,37
Phrynocephalus axillaris,17937,13,22,2,37
Perccottus glenii,16487,13,22,2,37
Lophiogobius ocellicauda,16663,13,22,2,37
Aesopia cornuta,16737,13,22,2,37
Maccullochella peelii,16442,13,22,2,37
Pastinachus ater,18162,13,22,2,37
Engaeus cunicularius,16042,13,22,2,37
Geocharax gracilis,15924,13,23,2,38
Euastacus yarraensis,15548,13,22,2,37
Sparus aurata,16652,13,22,2,37
Grapholita dimorpha,15813,13,22,2,37
Orius sauteri,16246,13,22,2,37
Arcos sp. KU 149,16534,13,22,2,37
Ochrogaster lunifer,15593,13,22,2,37
Pseudopungtungia nigra,16583,13,22,2,37
Parnassius bremeri,15389,13,22,2,37
Bathyteuthis abyssicola,20075,17,23,2,42
Semirossia patagonica,17086,13,22,2,37
Thelazia callipaeda,13668,12,22,2,36
Trichuris discolor,13904,13,22,2,37
Trichuris ovis,13946,13,22,2,37
Psettodes erumei,17315,13,22,2,37
Barbodes semifasciolatus,16594,13,22,2,37
Puntius snyderi,16578,13,22,2,37
Pseudohynobius shuichengensis,16394,13,22,2,37
Nautilocaris saintlaurentae,15928,13,22,2,37
Antricola mexicanus,14415,13,22,2,37
Ixodes pavlovskyi,14575,13,22,2,37
Paranephrops planifrons,16174,13,22,2,37
Nephrops norvegicus,16132,13,21,2,36
Labeo fimbriatus,16614,13,22,2,37
Pseudosiderastrea formosa,19475,13,2,2,17
Corvus frugilegus,16931,13,22,2,37
Katsuwonus pelamis,16515,13,22,2,37
Sasakia charonda,15244,13,22,2,37
Hoplobatrachus tigerinus,20462,13,23,2,38
Thunnus alalunga,16527,13,22,2,37
Psilorhynchus homaloptera,16569,13,22,2,37
Micropterus dolomieu,16488,13,22,2,37
Trichiosoma anthracinum,15392,13,20,2,35
Coptotermes remotus,14742,13,22,2,37
Heterotermes cf. paradoxus AUS88,14929,13,22,2,37
Heterotermes cf. paradoxus AUS103,14929,13,22,2,37
Heterotermes cf. paradoxus AUS121,14904,13,22,2,37
Heterotermes malabaricus,14912,13,22,2,37
Heterotermes nr. tenuis COL.4PUERTO,14944,13,22,2,37
Heterotermes cf. occiduus 3.12.2.AUS,14936,13,22,2,37
Heterotermes cf. occiduus 3.15.2AUS,14919,13,22,2,37
Heterotermes validus,14922,13,22,2,37
Sprattus muelleri,16726,13,22,2,37
Pagurus longicarpus,15630,13,22,2,37
Hyperlophus vittatus,16653,13,22,2,37
Sprattus antipodum,16707,13,22,2,37
Potamalosa richmondia,16681,13,22,2,37
Odaxothrissa losera,16730,13,22,2,37
Microthrissa royauxi,16738,13,22,2,37
Potamothrissa acutirostris,16736,13,22,2,37
Konosirus punctatus,16698,13,22,2,37
Potamothrissa obtusirostris,16736,13,22,2,37
Tenualosa toli,16541,13,22,2,37
Clupeichthys perakensis,16672,13,22,2,37
Escualosa thoracata,16749,13,22,2,37
Clupeoides borneensis,16661,13,22,2,37
Ethmidium maculatum,16741,13,22,2,37
Gudusia chapra,16554,13,22,2,37
Ehirava fluviatilis,16689,13,22,2,37
Tenualosa thibaudeaui,16560,13,22,2,37
Clupeichthys goniognathus,16712,13,22,2,37
Sundasalanx praecox,16748,13,22,2,37
Sardinella albella,16652,13,22,2,37
Stichopathes luetkeni,20448,14,2,2,18
Scopelengys tristis,16768,13,22,2,37
Neoscopelus macrolepidotus,16609,13,22,2,37
Lampadena atlantica,17807,13,22,2,37
Amblyomma cajennense,14780,13,22,2,37
Haemaphysalis formosensis,14676,13,22,2,37
Dendronephthya mollis,18844,14,1,2,17
Echinogorgia complexa,19445,14,1,2,17
Euplexaura crassa,18674,14,1,2,17
Alouatta caraya,16517,13,22,2,37
Aotus azarai,16555,13,22,2,37
Avahi laniger,16787,13,22,2,37
Callithrix geoffroyi,16502,13,22,2,37
Cebuella pygmaea,16520,13,22,2,37
Cercocebus chrysogaster,16551,13,22,2,37
Cercopithecus albogularis,16544,13,22,2,37
Cheirogaleus medius,16804,13,22,2,37
Chiropotes albinasus,16706,13,22,2,37
Erythrocebus patas,16676,13,22,2,37
Eulemur rufus,16280,13,22,2,37
Galago moholi,16650,13,22,2,37
Hapalemur griseus,16878,13,22,2,37
Lagothrix lagotricha,16595,13,22,2,37
Leontopithecus rosalia,16872,13,22,2,37
Lepilemur ruficaudatus,16936,13,22,2,37
Lophocebus aterrimus,16563,13,22,2,37
Loris lydekkerianus,16791,13,22,2,37
Mandrillus sphinx,16546,13,22,2,37
Nomascus leucogenys,16478,13,22,2,37
Nycticebus bengalensis,16735,13,22,2,37
Prolemur simus,16765,13,22,2,37
Saguinus oedipus,16551,13,22,2,37
Sapajus xanthosternos,16527,13,22,2,37
Babina holsti,19113,13,22,2,37
Babina subaspera,18525,13,22,2,37
Nidirana okinavana,19959,13,22,2,37
Achirus lineatus,16577,13,22,2,37
Trinectes maculatus,16553,13,22,2,37
Chabertia erschowi,13705,12,22,2,36
Phodilus badius,17086,13,22,2,37
Sagittarius serpentarius,16773,13,22,2,37
Botrylloides violaceus,14357,13,24,2,39
Lygus hesperus,17747,13,22,2,37
Schizothorax davidi,16576,13,22,2,37
Schizopygopsis pylzovi,16664,13,22,2,37
Euastacus spinifer,15558,13,22,2,37
Astacopsis gouldi,16678,13,21,2,36
Gazza minuta,16475,13,22,2,37
Lobotes surinamensis,16782,13,22,2,37
Gerres oyena,16839,13,22,2,37
Polydactylus plebeius,16765,13,22,2,37
Polynemus paradiseus,16710,13,22,2,37
Pempheris schwenkii,16516,13,22,2,37
Metapenaeus ensis,15944,13,22,2,37
Hypselecara temporalis,16544,13,22,2,37
Enoplosus armatus,16508,13,22,2,37
Microcanthus strigatus,16531,13,22,2,37
Ellipes minuta,15451,13,22,2,37
Heteroconger hassi,17768,13,22,2,37
Thunnus thynnus,16527,13,22,2,37
Thunnus obesus,16528,13,22,2,37
Carassius gibelio,16581,13,22,2,37
Amblydoras gonzalezi,16505,13,22,2,37
Hydrosaurus amboinensis,16129,13,22,2,37
Amphilius sp. NM-2010,16539,13,22,2,37
Pterygoplichthys disjunctivus,16521,13,22,2,37
Duringlanis perugiae,16677,13,22,2,37
Clarias sp. NM-2010,16508,13,22,2,37
Lebiasina astrigata,16899,13,22,2,37
Myleus sp. NM-2010,16664,13,22,2,37
Ichthyborus sp. NM-2010,16524,13,22,2,37
Micralestes sp. NM-2010,16660,13,22,2,37
Acestrorhynchus sp. NM-2010,16758,13,22,2,37
Mauremys sinensis,16461,13,22,2,37
Bothriocroton concolor,14809,13,22,2,37
Bothriocroton undatum,14769,13,22,2,37
Amblyomma fimbriatum,14705,13,22,2,37
Ciona intestinalis B CG-2006,14591,13,24,2,39
Atractosteus spatula,16262,13,22,2,37
Crossorhombus azureus,16792,13,22,2,37
Leiolepis reevesii,16908,13,22,2,37
Trichopodus trichopterus,16452,13,22,2,37
Onychodactylus zhaoermii,16533,13,22,2,37
Ilyonectria destructans,42895,15,29,2,46
Melanagromyza sojae,15475,13,22,2,37
Sinocrossocheilus labiatus,16603,13,22,2,37
Anopheles homunculus,15739,13,22,2,37
Anopheles bellator,15668,13,22,2,37
Anopheles laneanus,15446,13,22,2,37
Hippocampus mohnikei,16518,13,22,2,37
Melanotaenia praecox,16536,13,22,2,37
Rhynchobatus australiae,16804,13,22,2,37
Munida gregaria,16326,13,22,2,37
Cynoglossus joyneri,16428,13,22,2,37
Creontiades dilutus,15864,13,22,2,37
Lamprotula scripta,16250,13,23,2,38
Datnioides undecimradiatus,16534,13,22,2,37
Stygobromus indentatus,14638,13,22,2,37
Reticulitermes labralis,15914,13,22,2,37
Tylomelania sarasinorum,16632,13,22,2,37
Mantis religiosa,15534,13,23,2,38
Tenodera sinensis,15531,13,22,2,37
Creobroter gemmatus,15716,13,24,2,39
Placobdella lamothei,15190,13,23,2,38
Antheraea assamensis,15312,13,22,2,37
Pateobatis jenkinsii,17670,13,22,2,37
Cichla ocellaris,16526,13,22,2,37
Anguis cephallonica,17208,13,22,2,37
Anthopleura anjunae,20039,13,2,2,17
Mierspenaeopsis hardwickii,15922,13,23,2,38
Datnioides microlepis,16439,12,22,2,36
Syngnathus typhle,16488,13,22,2,37
Solenocera crassicornis,15946,13,22,2,37
Morone americana,17966,13,22,2,37
Rediviva intermixta,16875,13,22,2,37
Heliodoxa aurescens,16718,13,22,2,37
Calliphlox amethystina,16871,13,22,2,37
Florisuga fusca,16810,13,22,2,37
Phaethornis malaris,16811,13,22,2,37
Schyzocotyle acheilognathi,13903,12,22,2,36
Schyzocotyle nayarensis,13852,12,22,2,36
Epinephelus moara x Hyporthodus septemfasciatus,16627,13,22,2,37
Pagothenia borchgrevinki,17299,13,22,2,37
Pseudobalistes fuscus,16480,13,22,2,37
Netuma thalassina,16711,13,22,2,37
Acipenser fulvescens,16542,13,22,2,37
Scaphirhynchus platorynchus,16495,13,22,2,37
Scaphirhynchus albus x Scaphirhynchus platorynchus,16495,13,22,2,37
Sinobatis borneensis,16701,13,22,2,37
Eothenomys miletus,16344,13,22,2,37
Angiostrongylus malaysiensis,13516,12,22,2,36
Telmatobius chusmisensis,19312,13,22,2,37
Beaufortia kweichowensis,16599,13,22,2,37
Lamprotula caveata,16641,13,22,2,37
Haliclystus antarcticus,15766,13,5,2,20
Aglaiogyrodactylus forficulatus,14371,12,22,2,36
Chrysoperla externa,16509,13,22,2,37
Mus famulus,16291,13,22,2,37
Acipenser nudiventris,16543,13,22,2,37
Cyprinodon diabolis,16499,13,22,2,37
Tubastraea tagusensis,19094,13,2,2,17
Lethrinus laticaudis,16758,13,22,2,37
Conus capitaneus,15829,13,22,0,35
Aneurus similis,16477,13,22,2,37
Aneurus sublobatus,16091,13,22,2,37
Aradus compar,16814,13,22,2,37
Libiocoris heissi,15168,13,22,2,37
Cynoglossus zanzibarensis,16569,13,22,2,37
Bothus myriaster,16873,13,22,2,37
Crossorhombus valderostratus,16790,13,22,2,37
Lophonectes gallus,18642,13,22,2,37
Emberiza elegans,16779,13,22,2,37
Dopasia gracilis,17788,13,22,2,37
Helicoverpa zea,15343,13,22,2,37
Sillago sinica,16572,13,22,2,37
Odontamblyopus lacepedii,17245,13,22,2,37
Lateolabrax latus,16479,13,22,2,37
Idea leuconoe,15278,13,22,2,37
Chirolophis japonicus,16521,13,22,2,37
Caulophryne jordani,16657,13,22,2,37
Gossypium raimondii,676078,39,30,6,75
Paretroplus maculatus,16486,13,22,2,37
Lama guanicoe,16649,13,22,2,37
Onchidella celtica,14150,13,25,2,40
Malcus inconspicuus,15575,13,22,2,37
Chiloscyllium plagiosum,16726,13,22,2,37
Gillichthys mirabilis,16481,13,22,2,37
natural gynogenetic Carassius auratus red var.,16580,13,22,2,37
Desmophyllum pertusum,16150,12,2,2,16
Pleurocorallium konojoi,18969,14,1,2,17
Trigonostigma espei,17162,13,22,2,37
Caulophryne pelagica,16649,13,22,2,37
Harengula jaguana,17158,13,22,2,37
Caretta caretta,16737,13,22,2,37
Chrysochir aureus,16505,13,22,2,37
Moolgarda cunnesius,16748,13,22,2,37
Macrotermes barneyi,15940,13,22,2,37
Angiostrongylus vasorum,13422,12,22,2,36
Herpele squalostoma,16073,13,22,2,37
Callitettix versicolor,15374,13,22,2,37
Kaloula borealis,17174,13,22,2,37
Platygyra carnosa,16463,13,2,2,17
Taenia martis,13536,12,22,2,36
Setipinna taty,16887,13,22,2,37
Abacion magnum,15160,13,22,2,37
Brachycybe lecontii,15115,13,22,2,37
Leptomyrmex pallens,15591,13,22,2,37
Breviceps adspersus,28757,13,24,3,40
Gymnodiptychus pachycheilus,16586,13,22,2,37
Metaphire vulgaris,15061,13,22,2,37
Polyplectron napoleonis,16710,13,22,2,37
Ifremeria nautilei,15664,13,22,2,37
Lepidodactylus lugubris,16762,13,22,2,37
Uroplatus ebenaui,16830,13,21,2,36
Asiotmethis jubatus,15669,13,22,2,37
Epacanthaclisis banksi,15870,13,22,2,37
Cirrhinus mrigala x Labeo rohita,16595,13,22,2,37
Sillago aeolus,16499,13,22,2,37
Atlantoraja castelnaui,16750,13,22,2,37
Upogebia yokoyai,16063,13,22,2,37
Melipona scutellaris,14862,13,21,2,36
Periparus ater,16783,13,22,2,37
Neomysis japonica,17652,13,22,2,37
Taractichthys steindachneri,16723,13,22,2,37
Zeugodacus diaphorus,15890,13,22,2,37
Plasmodium gallinaceum,6003,3,0,15,18
Gigaspora margarita,96998,19,22,2,43
Gelidium vagum,24901,23,17,2,42
Grateloupia angusta,27943,26,18,2,46
Bathycoccus prasinos,43614,41,26,4,71
Sporolithon durum,26202,23,19,2,44
Gelidium elegans,24922,23,18,2,43
Ahnfeltia plicata,32878,24,24,2,50
Hildenbrandia rubra,33066,22,18,2,42
Palmaria palmata,29735,26,22,2,50
Calliarthron tuberculosum,26469,25,19,2,46
Allomyces macrogynus,57473,25,25,2,52
Achlya hypogyna,46840,43,29,4,76
Chlorella variabilis,78500,32,27,3,62
Oltmannsiellopsis viridis,56761,36,24,3,63
Uromastyx benti,16380,13,22,2,37
Galdieria sulphuraria,21428,19,7,2,28
Ectocarpus siliculosus,37189,40,25,3,68
Benthodesmus tenuis,16864,13,22,2,37
Pelusios castaneus,16761,13,22,2,37
Cladophialophora bantiana,26821,16,22,2,40
Beauveria malawiensis,44135,30,25,1,56
Schmidtea mediterranea,27133,12,22,2,36
Lipolagus ochotensis,17338,13,22,2,37
Scorpis lineolata,16501,13,22,2,37
Ariosoma shiroanago,16922,13,22,2,37
Arborophila rufipectus,16728,13,22,2,37
Odontamblyopus rebecca,17009,13,22,2,37
Triplophysa tibetana,16574,13,22,2,37
Macrhybopsis storeriana,16709,13,22,2,37
Triplophysa orientalis,16562,13,22,2,37
Triplophysa stewarti,16567,13,22,2,37
Numenius phaeopus,17091,13,22,2,37
Hypsopygia regina,15212,13,22,2,37
Evergestis junctalis,15438,13,22,2,37
Tyspanodes striata,15255,13,22,2,37
Triplophysa tenuis,16571,13,22,2,37
Triplophysa wuweiensis,16681,13,22,2,37
Triplophysa xichangensis,16570,13,22,2,37
Cherax sp. HMG-2016,15904,13,22,2,37
Echinochasmus japonicus,15865,12,22,2,36
Symplecta hybrida,15811,13,22,2,37
Tipula cockerelliana,14453,13,21,2,36
Triplophysa lixianensis,16570,13,22,2,37
Notoraja tobitukai,16799,13,22,2,37
Fasciolopsis buski,14833,12,22,2,36
Fischoederius cobboldi,14256,12,22,2,36
Homalogaster paloniae,15987,12,22,2,36
Gramastacus insolitus,15704,13,22,2,37
Saccostrea kegaki,16260,12,23,3,38
Conus striatus,15738,13,22,2,37
Elysia ornata,14188,13,22,2,37
Tachysurus argentivittatus,16534,13,22,2,37
Channa micropeltes,16567,13,22,2,37
Copadichromis mloto,16583,13,22,2,37
Tringa erythropus,16683,13,22,2,37
Yunnanacris yunnaneus,15475,13,22,2,37
Hieroglyphus tonkinensis,15625,13,22,2,37
Minla ignotincta,17868,13,22,2,37
Amphiprion ephippium,16840,13,22,2,37
Amphiprion akallopisos,16840,13,22,2,37
Amphiprion sebae,16845,13,22,2,37
Abax parallelepipedus,17701,13,22,2,37
Hygrobia hermanni,16336,13,22,2,37
Liposcelis keleri,14334,12,21,2,35
Littorina saxatilis,16887,13,22,2,37
Sargocentron spiniferum,16548,13,22,2,37
Cecropterus lyciades,15612,13,22,2,37
Copsychus saularis,16827,13,22,2,37
Lanius schach,16820,13,22,2,37
Oreolalax major,17431,13,23,2,38
Copadichromis quadrimaculatus,16583,13,23,2,38
Dimidiochromis kiwinge,16581,13,22,2,37
Macrhybopsis hyostoma,16899,13,22,2,37
Calliptamus abbreviatus,15558,13,22,2,37
Oreolalax lichuanensis,17702,13,22,2,37
Leiocassis longirostris x Tachysurus fulvidraco,16534,13,22,2,37
Biston thibetaria,15485,13,22,2,37
Mytilus chilensis,16765,13,23,2,38
Yaoshania pachychilus,16564,13,22,2,37
Saccharina angustata,37605,38,24,3,65
Saccharina coriacea,37500,38,24,3,65
Saccharina japonica,37657,38,25,3,66
Saccharina religiosa,37657,38,24,3,65
Saccharina ochotensis,37656,38,24,3,65
Saccharina diabolica,37657,38,24,3,65
Lentinula edodes,121394,27,26,1,54
Andalucia godoyi,67656,72,29,3,104
Saccharina longipedalis,37657,38,24,3,65
Jakoba libera,100252,84,26,3,113
Muricea crassa,19586,14,1,2,17
Diphylleia rotans,62563,58,27,3,88
Schizosaccharomyces octosporus,44227,14,25,2,41
Candida parapsilosis,32745,20,24,2,46
Rhagophthalmus ohbai,15704,13,19,2,34
Tetradesmus obliquus,42781,20,27,6,53
Thylacodes squamigerus,15544,13,24,4,41
Rita rita,16449,13,22,2,37
Phlaeoba tenebrosa,15648,13,22,2,37
Nuttallia olivacea,18182,12,22,2,36
Loliolus japonicus,17232,13,22,2,37
Histiona aroides,70177,72,26,3,101
Spadella cephaloptera,11905,11,0,2,13
Craspedacusta sowerbii,17922,15,2,2,19
Platevindex mortoni,13991,13,24,2,39
Eulimnogammarus verrucosus,15315,13,22,2,37
Aplysia kurodai,14131,13,22,2,37
Hemiodoecus leai,15949,13,22,2,37
Dermacentor silvarum,14945,13,22,2,37
Ibalia leucospoides,17212,13,24,2,39
Turritella bacillum,15868,13,22,2,37
Grapsus tenuicrustatus,15858,13,22,2,37
Wasmannia auropunctata,16362,13,22,2,37
Agriosphodrus dohrni,16470,13,22,2,37
Leucoptera malifoliella,15646,13,22,2,37
Placida sp. 1 NY-2013,14751,13,22,2,37
Ganoderma applanatum,119803,15,25,2,42
Squilla mantis,15994,13,22,2,37
Locusta migratoria manilensis,15895,13,22,2,37
Eriocheir japonica,16352,13,22,2,37
Eriocheir hepuensis,16335,13,22,2,37
Leptotila verreauxi,17176,13,22,2,37
Nymphicus hollandicus,16781,13,22,2,37
Eupsittula pertinax chrysogenys,16980,13,22,2,37
Psittacara acuticaudatus acuticaudatus,16998,13,22,2,37
Sepia pharaonis,16208,13,22,2,37
Psococerastis albimaculata,15589,13,22,2,37
Bucorvus leadbeateri,17061,13,22,2,37
Papilio maackii,15357,13,22,2,37
Bycanistes brevis,17591,13,22,2,37
Psittacara brevipes,16972,13,22,2,37
Rhynchopsitta terrisi,17027,13,22,2,37
Retinia pseudotsugaicola,15282,13,22,2,37
Zenaida auriculata,16781,13,22,2,37
Chaceon granulatus,16135,13,22,2,37
Geotrygon violacea,16864,13,22,2,37
Hirudo nipponia,14414,13,22,2,37
Papilio syfanius,15359,13,22,2,37
Samia canningi,15384,13,22,2,37
Allantus luctifer,15418,13,22,2,37
Filchnerella beicki,15658,13,22,2,37
Primolius couloni,16995,13,22,2,37
Glyphodes pyloalis,14960,13,22,2,37
Sarcophaga africa,15144,13,22,2,37
Ara glaucogularis,16983,13,22,2,37
Psittacara rubritorquis,16979,13,22,2,37
Sarcophaga melanura,15190,13,22,2,37
Darthula hardwickii,15355,13,22,2,37
Loliolus uyii,17134,12,22,2,36
Nyssomyia umbratilis,15757,13,22,2,37
Teinopalpus imperialis,15229,13,22,2,37
Neuronema laminatum,17948,13,22,2,37
Asclepias syriaca,682498,37,27,3,67
Drosophila formosana,16100,13,22,2,37
Chilo sacchariphagus,15378,13,22,2,37
Gasterophilus intestinalis,15660,13,22,2,37
Acremonium fuci,24565,15,28,2,45
Nectria cinnabarina,69895,15,25,2,42
Globisporangium ultimum,59689,67,42,4,113
Pleurotus ostreatus,73242,26,24,2,52
Euploea midamus,15187,13,22,2,37
Geranium maderense,737091,27,31,3,61
Euproctis pseudoconspersa,15461,13,22,2,37
Pseudo-nitzschia multiseries,46283,39,24,2,65
Uroteuthis duvaucelii,17413,13,22,2,37
Ara militaris,16990,13,22,2,37
Amazona ochrocephala,18909,13,22,2,37
Coracopsis vasa,16902,13,22,2,37
Eclectus roratus,16842,13,22,2,37
Forpus passerinus,18461,13,22,2,37
Myiopsitta monachus,16755,13,22,2,37
Prioniturus luconensis,18525,12,22,2,36
Psittacus erithacus,17962,12,22,2,36
Psittrichas fulgidus,16776,13,22,2,37
Panulirus cygnus,15724,13,22,2,37
Loliolus beka,17483,13,22,2,37
Uroteuthis chinensis,17353,13,22,2,37
Gossypium barbadense,677434,36,24,3,63
Pyrrhura rupicola,16994,13,22,2,37
Phasianella solida,16698,13,22,2,37
Orthopsittaca manilatus,16985,13,22,2,37
Brassica nigra,232407,77,19,3,99
Ara ararauna,16982,13,22,2,37
Primolius maracana,16999,13,22,2,37
Dorcoceras hygrometricum,510519,32,27,4,63
Lachancea kluyveri,51679,8,24,1,33
Ajuga reptans,352069,30,17,3,50
Neoceratodus forsteri,16572,13,22,2,37
Dermacentor nitens,14839,13,22,2,37
Nelumbo nucifera,524797,44,21,6,71
Chrysaora quinquecirrha,16775,15,2,2,19
Ponticola kessleri,16890,13,22,2,37
Polypterus mokelembembe,16629,13,22,2,37
Anopheles oryzalimnetes,15422,13,22,2,37
Anopheles albitarsis G Krzywinski et al._ 2011,15474,13,22,2,37
Anopheles janconnae,15425,13,22,2,37
Anopheles albitarsis F Brochero et al._ 2007,15418,13,22,2,37
Ophioglossum californicum,372339,37,24,3,64
Psilotum nudum,364070,26,7,4,37
Tupiella akineta,95880,72,25,2,99
Sinibotia reevesae,16572,13,22,2,37
Saprolegnia ferax,46930,43,30,4,77
Saccharina sculpera,37627,38,24,2,64
Agrilus planipennis,15942,13,22,2,37
Pseudogastromyzon fasciatus,16563,13,22,2,37
Bothrops jararaca,17526,13,22,2,37
Velarifictorus hemelytrus,16123,13,22,2,37
Sitophilus zeamais,18105,13,22,2,37
Sitophilus oryzae,17602,13,22,2,37
Periophthalmodon schlosseri,16470,13,22,2,37
Orconectes punctimanus,15815,13,22,2,37
Biston perclara,15493,13,22,2,37
Cyanoderma ruficeps,16885,13,22,2,37
Hypselodoris festiva,14880,13,22,2,37
Scincella vandenburghi,17103,13,22,2,37
Osmoderma opicum,15341,13,22,1,36
Scincella huanrenensis,17212,13,22,2,37
Azemiops feae,17383,13,22,2,37
Xylotrechus grayii,15540,13,22,2,37
Callithrix penicillata,16246,13,22,2,37
Polyrhachis dives,15761,13,22,2,37
Saccharum officinarum,300784,20,16,6,42
Mastocarpus papillatus,25906,26,22,2,50
Saccharomyces kudriavzevii,72095,7,24,2,33
Saccharomyces mikatae,73485,7,24,2,33
Brachythecium rivulare,104460,46,24,3,73
Piaractus brachypomus,16722,13,22,2,37
Cynoponticus ferox,17822,13,22,2,37
Misgurnus anguillicaudatus x Paramisgurnus dabryanus,16647,13,22,2,37
Hesperelaea palmeri,658522,48,19,3,70
Babesia microti,11109,3,0,6,9
Ipomoea nil,265768,30,20,3,53
Parapoynx crisonalis,15374,13,22,2,37
Acheilognathus meridianus,16563,13,22,2,37
Callianassa ceramica,16899,13,22,2,37
Macaca leucogenys,16565,13,22,2,37
Fringilla polatzeki,16785,13,22,2,37
Reticulitermes flaviceps,16485,13,22,2,37
Monacoa grimaldii,16609,13,22,2,37
Acipenser mikadoi,16610,13,22,2,37
Cacospongia mycofijiensis,16227,14,2,2,18
Urocitellus richardsonii,16460,13,22,2,37
Callospermophilus lateralis,16457,13,22,2,37
Turritopsis dohrnii,15425,13,2,2,17
Tetraodon nigroviridis,16448,13,22,2,37
Scirpophaga incertulas,15220,13,22,2,37
Uropsilus gracilis,16536,13,22,2,37
Malaclemys terrapin terrapin,16717,13,22,2,37
Lutjanus erythropterus,16509,13,22,2,37
Ruditapes philippinarum,22089,13,24,2,39
Sarcoptes scabiei,13919,0,20,2,22
Limnephilus decipiens,16667,13,22,2,37
Corchorus capsularis,1999602,37,31,3,71
Corchorus olitorius,1829341,35,34,3,72
Haliotis discus hannai x Haliotis iris,16719,13,22,2,37
Ricania speculum,15729,13,22,2,37
Glarea lozoyensis,45501,22,33,2,57
Histiostoma blomquisti,15892,13,22,2,37
Tolypocladium ophioglossoides,35159,19,25,2,46
Orthotrichum bicolor,104736,40,24,3,67
Orthotrichum callistomum,104785,40,24,3,67
Orthotrichum gymnostomum,104638,40,24,3,67
Stoneobryum bunyaense,104352,40,24,3,67
Ulota crispa,104636,40,24,3,67
Plenogemma phyllantha,104671,40,24,3,67
Curvipennis wixiensis,15528,13,22,2,37
Typosyllis antoni,16897,13,23,2,38
Paramoeba pemaquidensis,48522,40,20,2,62
Sugiyamaella lignohabitans,43869,7,40,0,47
Protonibea diacanthus,16521,13,22,2,37
Pantholops hodgsonii,16498,13,22,2,37
Idioscopus nitidulus,15287,13,22,2,37
Rhodosoma turcicum,14677,13,23,2,38
Crassostrea gigas,18224,12,23,4,39
Gyrodactylus brachymystacis,14767,12,22,2,36
Pinguinus impennis,16784,13,22,2,37
Moho braccatus,16804,13,22,2,37
Akialoa obscura,16838,13,22,2,37
Callaeas cinereus,16711,13,22,2,37
Heteralocha acutirostris,16766,13,22,2,37
Myadestes myadestinus,16641,13,22,2,37
Psittirostra psittacea,16841,13,22,2,37
Haliotis iris,17131,13,22,2,37
Osphronemus goramy,16526,13,22,2,37
Panaorus albomaculatus,16345,13,22,2,37
Dirofilaria sp. 'hongkongensis',13680,12,22,2,36
Penaeus indicus,16071,13,22,2,37
Retropinna semoni,16577,13,22,2,37
Eophona migratoria,16798,13,22,2,37
Schistura scaturigina,16585,13,22,2,37
Fruhstorferiola huayinensis,16227,13,22,2,37
Psalidodon paranae,16707,13,22,2,37
Chrysomya phaonis,15831,13,23,2,38
Sinocyclocheilus bicornutus,17426,13,22,2,37
Aphis craccivora,15308,13,22,2,37
Eusyllis blomstrandi,14712,13,22,2,37
Myrianida brachycephala,15032,13,22,2,37
Menathais tuberosa,15294,13,22,2,37
Ramazzottius varieornatus,14428,13,22,2,37
Pennahia macrocephalus,16508,13,22,2,37
Leptobrachium leishanense,17485,13,23,2,38
Phascolosoma pacificum,16039,13,23,2,38
Hemitilapia oxyrhynchus,16583,13,22,2,37
Buccochromis nototaenia,16580,13,22,2,37
Serranochromis robustus,16583,13,22,2,37
Lethrinops lethrinus,16582,13,22,2,37
Pristigenys niphonia,16519,13,22,2,37
Scutiger ningshanensis,17265,13,22,2,37
Carassioides acuminatus,16579,13,22,2,37
Pseudogobius taijiangensis,16502,13,22,2,37
Mauremys leprosa,17067,13,22,2,37
Gyrodactylus parvae,14702,12,22,2,36
Mikrogeophagus ramirezi,16526,13,22,2,37
Krobia guianensis,16539,13,22,2,37
Streptopelia orientalis,17130,13,22,2,37
Pyramimonas parkeae,43294,42,35,2,79
Saccharomyces arboricola,71124,14,24,2,40
Saccharomyces uvarum,64779,13,24,2,39
Saccharomyces bayanus,64736,13,24,2,39
Saccharomyces cariocanus,77380,14,24,2,40
Saccharomyces pastorianus,69019,13,24,2,39
Corvus moriorum,15593,13,22,2,37
Cocos nucifera,678653,81,41,6,128
Orthotrichum obtusifolium,104603,40,24,3,67
Palpitomonas bilix,76874,72,48,6,126
Gelidium sinicola,24969,23,18,2,43
Pterocladia robusta,24935,23,19,2,44
Sinapis arvensis,240024,70,18,3,91
Peltigera dolichorrhiza,51156,18,26,2,46
Kappaphycus alvarezii,25198,24,23,2,49
Pestalotiopsis fici,69529,44,32,2,78
Gelidium arborescens,24935,23,19,2,44
Gelidium galapagense,24970,23,18,2,43
Gelidium isabelae,24937,23,18,2,43
Gelidium sclerophyllum,24916,23,19,2,44
Pterocladiella media,24915,23,19,2,44
Pterocladia mexicana,24932,23,19,2,44
Pterocladiella musciformis,24927,23,19,2,44
Zygodon viridissimus,103098,40,24,3,67
Navicula ramosissima,48652,42,24,2,68
Chiromantes neglectus,15920,13,22,2,37
Columba jouyi,17179,13,22,2,37
Alopecoenas salamonis,17141,13,22,2,37
Phlaeoba infumata,15642,13,22,2,37
Euthrix laeta,15368,13,22,2,37
Squaliolus aliae,16717,13,22,2,37
Triodontophorus serratus,13794,12,22,2,36
Triodontophorus nipponicus,13701,12,22,2,36
Amblyrhynchichthys truncatus,16600,13,22,2,37
Aulopyge huegelii,16593,13,22,2,37
Barbonymus altus,16588,13,22,2,37
Capoeta damascina,16608,13,22,2,37
Catlocarpio siamensis,16549,13,22,2,37
Cyclocheilichthys janthochir,16580,13,22,2,37
Probarbus jullieni,16572,13,22,2,37
Sawbwa resplendens,16571,13,22,2,37
Systomus orphoides,16593,13,22,2,37
Labeobarbus maroccanus,16598,13,22,2,37
Onychostoma fangi,16597,13,22,2,37
Enteromius hulstaerti,16775,13,22,2,37
Labeobarbus intermedius,16581,13,22,2,37
Luciobarbus sclateri,16608,13,22,2,37
Labiobarbus spilopleura,16593,13,22,2,37
Epalzeorhynchos bicolor,16465,13,22,2,37
Garra congoensis,16761,13,22,2,37
Labeo cylindricus,16602,13,22,2,37
Schizothorax nepalensis,16589,13,22,2,37
Rhodeus amarus,16607,13,22,2,37
Vimba melanops,16604,13,22,2,37
Squalius cephalus,16612,13,22,2,37
Metzia lineata,16614,13,22,2,37
Rasbora sumatrana,16539,13,22,2,37
Psilorhynchus pseudecheneis,16554,13,22,2,37
Gyrinocheilus pennocki,16611,13,22,2,37
Sabanejewia radnensis,16582,13,22,2,37
Syncrossus beauforti,16567,13,22,2,37
Gastromyzon zebrinus,16566,13,22,2,37
Oxynoemacheilus angorae,16566,13,22,2,37
Capoeta aculeata,16602,13,22,2,37
Barboides gracilis,16566,13,22,2,37
Acrossocheilus iridescens,16596,13,22,2,37
Balantiocheilos melanopterus,16523,13,22,2,37
Puntioplites proctozystron,16584,13,22,2,37
Cyclocheilichthys apogon,16586,13,22,2,37
Neolissochilus stracheyi,16584,13,22,2,37
Cyprinion semiplotum,16581,13,22,2,37
Albulichthys albuloides,16592,13,22,2,37
Romanogobio ciscaucasicus,16603,13,22,2,37
Osteobrama cunma,16650,13,22,2,37
Osteobrama feae,16578,13,22,2,37
Scardinius erythrophthalmus,16607,13,22,2,37
Acanthobrama persidis,16613,13,22,2,37
Aspiolucius esocinus,16607,13,22,2,37
Tampichthys ipni,16698,13,22,2,37
Algansea lacustris,16719,13,22,2,37
Yuriria alta,16715,13,22,2,37
Hybognathus nuchalis,16712,13,22,2,37
Couesius plumbeus,16600,13,22,2,37
Platygobio gracilis,16721,13,22,2,37
Chrosomus erythrogaster,16598,13,22,2,37
Erimystax dissimilis,16653,13,22,2,37
Clinostomus elongatus,16650,13,22,2,37
Alburnus mossulensis,16604,13,22,2,37
Pseudochondrostoma polylepis,16606,13,22,2,37
Opsaridium ubangiense,16694,13,22,2,37
Canthophrys gongota,16561,13,22,2,37
Sewellia albisuera,16529,13,22,2,37
Gastromyzon scitulus,16565,13,22,2,37
Oreonectes platycephalus,16580,13,22,2,37
Schistura kaysonei,16575,13,22,2,37
Traccatichthys taeniatus,16582,13,22,2,37
Aborichthys elongatus,16544,13,22,2,37
Nemachilichthys rueppelli,16560,13,22,2,37
Schistura jarutanini,16594,13,22,2,37
Schistura notostigma,16568,13,22,2,37
Sikukia gudgeri,16587,13,22,2,37
Hypselobarbus jerdoni,16602,13,22,2,37
Barbodes lateristriga,16586,13,22,2,37
Poropuntius normani,16592,13,22,2,37
Discherodontus ashmeadi,16566,13,22,2,37
Discherodontus schroederi,16571,13,22,2,37
Pangio oblonga,16600,13,22,2,37
Lepidocephalichthys guntea,16567,13,22,2,37
Pangio cuneovirgata,16596,13,22,2,37
Lepidocephalichthys micropogon,16608,13,22,2,37
Lepidocephalus macrochir,16556,13,22,2,37
Kottelatlimia pristes,16588,13,22,2,37
Pangio cf. anguillaris CBM ZF 11605,16597,13,22,2,37
Pangio kuhlii,16601,13,22,2,37
Yasuhikotakia morleti,16567,13,22,2,37
Botia udomritthiruji,16591,13,22,2,37
Leptobotia pellegrini,16595,13,22,2,37
Onychostoma meridionale,16595,13,22,2,37
Poropuntius bantamensis,16594,13,22,2,37
Scaphiodonichthys burmanicus,16592,13,22,2,37
Folifer brevifilis,16707,13,22,2,37
Incisilabeo behri,16604,13,22,2,37
Cirrhinus microlepis,16578,13,22,2,37
Thynnichthys thynnoides,16589,13,22,2,37
Puntigrus partipentazona,16597,13,22,2,37
Puntius eugrammus,16847,13,22,2,37
Cosmochilus harmandi,16592,13,22,2,37
Chagunius chagunio,17017,13,22,2,37
Dawkinsia tambraparniei,16610,13,22,2,37
Scaphognathops bandanensis,16587,13,22,2,37
Enteromius fasciolatus,16566,13,22,2,37
Enteromius eburneensis,16678,13,22,2,37
Cyclocheilichthys heteronema,16573,13,22,2,37
Barbodes aurotaeniatus,16562,13,22,2,37
Hypsibarbus salweenensis,16588,13,22,2,37
Hypsibarbus vernayi,16590,13,22,2,37
Labeo dussumieri,16613,13,22,2,37
Henicorhynchus siamensis,17010,13,22,2,37
Crossocheilus reticulatus,16588,13,22,2,37
Osteochilus pentalineatus,16563,13,22,2,37
Mesonoemacheilus triangularis,16576,13,22,2,37
Clypeobarbus pleuropholis,16570,13,22,2,37
Garra poecilura,16978,13,22,2,37
Squalius lepidus,16594,13,22,2,37
Devario devario,16991,13,22,2,37
Tanichthys micagemmae,16555,13,22,2,37
Psilorhynchus balitora,16503,13,22,2,37
Thoburnia rhothoeca,16626,13,22,2,37
Homaloptera parclitella,16577,13,22,2,37
Homaloptera ogilviei,16575,13,22,2,37
Vanmanenia hainanensis,16555,13,22,2,37
Petruichthys brevis,16573,13,22,2,37
Schistura pridii,16576,13,22,2,37
Nemacheilus masyai,16538,13,22,2,37
Schistura corica,16572,13,22,2,37
Oxyeleotris marmorata,16525,13,22,2,37
Fusarium pseudograminearum CS3096,50404,0,0,0,0
Fusarium pseudograminearum CS3096,59510,0,0,0,0
Choreocolax polysiphoniae,25357,23,20,2,45
Vertebrata lanosa,25337,23,19,2,44
Anoplocephala magna,13759,12,22,2,36
Cricetulus migratorius,16246,13,22,2,37
Schizothorax gongshanensis,16591,13,22,2,37
(Cyprinus carpio 'mirror' x Cyprinus carpio 'singuonensis') x Carassius auratus red var.,16581,13,22,2,37
Cyprinus carpio 'mirror' x Cyprinus carpio 'singuonensis',16581,13,22,2,37
Phodopus roborovskii,16273,13,22,2,37
Etmopterus pusillus,16729,13,22,2,37
Halaelurus buergeri,19100,13,22,2,37
Eusphyra blochii,16727,13,22,2,37
Gymnocypris potanini,16680,13,22,2,37
Fruhstorferiola tonkinensis,15638,13,22,2,37
Squalus formosus,16735,13,22,2,37
Prunella strophiata,16830,13,22,2,37
Epicauta aptera,15645,13,22,2,37
Anax imperator,16087,13,22,2,37
Megaloprepus caerulatus,16094,13,22,2,37
Ischnura elegans,15962,13,22,2,37
Crossocheilus siamensis,16611,13,22,2,37
Pycnonotus xanthorrhous,16952,13,22,2,37
Stathmopoda auriferella,15456,13,22,2,37
Rusa unicolor,16437,13,22,2,37
Melophus lathami,16799,13,22,2,37
Hylopetes alboniger,16584,13,22,2,37
Sinotaia quadrata,17485,13,22,2,37
Lunella granulata,17190,13,22,2,37
Astralium haematragum,16310,13,21,2,36
Angaria delphinus,19554,13,22,2,37
Stomatella planulata,17151,13,21,2,36
Zenaida macroura,17132,13,22,2,37
Raphus cucullatus,17092,13,22,2,37
Goura cristata,17082,13,22,2,37
Didunculus strigirostris,17071,13,22,2,37
Columba rupestris,17201,13,22,2,37
Caloenas nicobarica,17090,13,22,2,37
Caloenas maculata,17036,13,22,2,37
Pycnophyes kielensis,14985,13,23,2,38
Eugnathogobius polylepis,16496,13,22,2,37
Phalcoboenus australis,17074,13,22,2,37
Asterionella formosa,61877,35,25,2,62
[Candida] intermedia,21871,3,0,0,3
Pleurocladia lacustris,37814,42,24,3,69
Aphanomyces astaci,49489,46,34,4,84
Aphanomyces invadans,49061,46,33,4,83
Epichloe typhina,84630,56,25,0,81
Epichloe festucae,88744,60,25,0,85
Didymosphenia geminata,37765,36,25,2,63
Coccophora langsdorfii,35660,37,25,3,65
Parengyodontium album,28081,17,24,2,43
Saldula arsenjevi,15324,13,22,2,37
Parasesarma tripectinis,15612,13,22,2,37
Paragonimus ohirai,14818,12,22,2,36
Liobagrus andersoni,16514,13,22,2,37
Polygyra cereolus,14008,13,22,2,37
Channa striata,16509,13,22,2,37
Cottus szanaga,16518,13,22,2,37
Somanniathelphusa boyangensis,17032,13,22,2,37
Orthetrum glaucum,15184,13,22,2,37
Orthetrum chrysis,15088,13,22,2,37
Orthetrum sabina,15176,13,22,2,37
Orthetrum testaceum,15162,13,22,2,37
Zosterops abyssinicus,17827,13,22,2,37
Zosterops poliogastrus,17974,13,22,2,37
Armillifer agkistrodontis,16521,13,22,2,37
Asymmetricata circumdata,15967,13,22,2,37
Hemipristis elongata,16691,13,22,2,37
Cladotaenia vulturi,13411,12,22,2,36
Trachelus iudaicus,20370,13,22,2,37
Trachelus tabidus,18539,13,22,2,37
Gnathostoma doloresi,13809,12,22,2,36
Poeciliopsis monacha,16818,13,22,2,37
Euborellia arcanum,16087,13,21,2,36
Oxya hyla,15483,13,22,2,37
Trigonidium sjostedti,15763,13,22,2,37
Praticolella mexicana,14153,13,22,2,37
Macrognathus pancalus,16549,13,22,2,37
Hypselobarbus pulchellus,16588,13,22,2,37
Mystus vittatus,16244,13,22,2,37
Achalinus spinalis,17165,13,22,2,37
Achalinus rufescens,17339,13,22,2,37
Epinephelus chlorostigma,16894,13,22,2,37
Orchesella cincta,15728,13,22,2,37
Eurema blanda,15123,13,22,2,37
Platysmacheilus longibarbatus,16615,13,22,2,37
Microphysogobio liaohensis,16609,13,22,2,37
Microphysogobio chenhsienensis,16610,13,22,2,37
Pseudogobio vaillanti,16607,13,22,2,37
Gobiobotia pappenheimi,16605,13,22,2,37
Gobio cynocephalus,16605,13,22,2,37
Cloacotaenia megalops,13887,12,22,2,36
Heosemys grandis,16581,13,22,2,37
Bullanga florida,15937,13,22,2,37
Cylicocyclus nassatus,13846,12,22,2,36
Batagur trivittata,16463,13,22,2,37
Stenella longirostris,16370,13,22,2,37
Sinopodisma tsinlingensis,15627,13,22,2,37
Emberiza siemsseni,16780,13,22,2,37
Butastur indicus,19059,13,22,2,37
Butastur liventer,19673,13,22,2,37
Glyptocidaris crenularis,15760,12,22,2,36
Amblyomma sculptum,14780,13,22,2,37
Californiconus californicus,15444,13,22,2,37
Dryophytes suweonensis,17448,13,22,2,37
Amphitetranychus viennensis,13085,13,22,2,37
Eudocima phalonia,15575,13,22,2,37
Oreonectes furcocaudalis,16569,13,22,2,37
Sinocyclocheilus ronganensis,16587,13,22,2,37
Schlechtendalia chinensis,16047,13,24,2,39
Kryptolebias hermaphroditus,17487,13,22,2,37
Hemigobius hoevenii,16469,13,22,2,37
Pampus minor,18062,13,23,2,38
Schizopygopsis stoliczkai,16833,13,22,2,37
Takifugu fasciatus x Takifugu flavidus,16443,13,22,2,37
Araneus angulatus,14205,13,22,2,37
Typhlomys cinereus,15011,13,21,2,36
Sargassum natans,34727,37,25,3,65
Sargassum fluitans,34727,37,25,3,65
Sargassum aquifolium,34761,37,24,3,64
Pleurotus eryngii,72650,34,24,1,59
Dasya binghamiae,26052,22,22,2,46
Castilleja paramensis,495499,34,29,3,66
Triparma laevis,39580,37,25,2,64
Closterium baillyanum,152089,49,28,3,80
Tetraphis pellucida,107730,41,24,3,68
Thitarodes sejilaensis,15290,13,22,2,37
Chlamydomonas moewusii,22897,14,4,9,27
Monema flavescens,15396,13,22,2,37
Dacus longicornis,16253,13,22,2,37
Triplophysa stenura,16569,13,22,2,37
Andraca theae,15737,13,22,2,37
Pimelodus maculatus,16561,13,22,2,37
Acipenser brevirostrum,16680,13,22,2,37
Tonkinacris sinensis,15627,13,22,2,37
Rasbora aprotaenia,16541,13,22,2,37
Rasbora lateristriata,16539,13,22,2,37
Terpsiphone atrocaudata,16954,13,22,2,37
Amazona aestiva,18853,13,22,2,37
Emberiza fucata,16752,13,22,2,37
Lytta caraganae,15636,13,22,2,37
Trichodes sinae,16047,13,22,2,37
Vespertilio murinus,16721,13,22,2,37
Simulium variegatum,15367,13,22,2,37
Chloronia mirifica,15877,13,22,2,37
Gnathopogon nicholsi,16606,13,22,2,37
Eriosoma lanigerum,15640,13,22,2,37
Pteronotus personatus,16570,13,22,2,37
Neotoma fuscipes,16294,13,22,2,37
Eulimnogammarus cyaneus,14370,13,22,2,37
Pallaseopsis kessleri,15759,13,22,2,37
Civettictis civetta,16589,13,22,2,37
Vema ewingi,17910,13,22,2,37
Laevipilina antarctica,18642,13,22,2,37
Nycticebus pygmaeus,16856,13,22,2,37
Chascanopsetta lugubris,17251,13,22,2,37
Epopella plicata,15296,13,25,2,40
Uraspis helvola,16555,13,22,2,37
Herzensteinia microcephalus,16726,13,22,2,37
Amazilia rondoniae,16820,13,22,2,37
Amazilia millerii,16821,13,22,2,37
Amazilia brevirostris,16811,13,22,2,37
Sardinella longiceps,16613,13,22,2,37
Diadema setosum,15708,13,22,2,37
Temnopleurus toreumaticus,15722,13,22,2,37
Temnopleurus reevesii,15710,13,22,2,37
Scomberomorus concolor,16699,13,22,2,37
Paleosepharia posticata,15729,13,22,2,37
Monticola gularis,16801,13,22,2,37
Modiolus modiolus,15816,13,22,2,37
Panopea abrupta,15381,13,22,2,37
Aequidens metae,16541,13,22,2,37
Geophagus steindachneri,16594,13,22,2,37
Herichthys cyanoguttatus,16540,13,22,2,37
Andinoacara pulcher,16513,13,22,2,37
Rocio octofasciata,16539,13,22,2,37
Retroculus lapidifer,16537,13,22,2,37
Uaru amphiacanthoides,16549,13,22,2,37
Cichlasoma dimerus,16617,13,22,2,37
Cryptoheros cutteri,16528,13,22,2,37
Caridina cf. nilotica HMG-2016,15497,13,22,2,37
Gmelinoides fasciatus,18114,13,23,2,38
Eublepharis macularius,17462,13,22,2,37
Eleginops maclovinus,16960,13,22,2,37
Nilaparvata bakeri,14394,13,22,2,37
Garra salweenica,16960,13,22,2,37
Rectoris posehensis,16594,13,22,2,37
Eugnathogobius oligactis,16497,13,22,2,37
Mindarus keteleerifoliae,15199,13,22,2,37
Glaucis hirsutus,16815,13,22,2,37
Lophornis magnificus,16499,13,22,2,37
Ambassis gymnocephalus,17388,13,22,2,37
Austropotamobius torrentium,15330,13,22,2,37
Cambaroides dauricus,16308,13,22,2,37
Cambaroides japonicus,16257,13,22,2,37
Cambarus robustus,15797,13,22,2,37
Orconectes luteus,16215,13,22,2,37
Pacifastacus leniusculus,16331,13,22,2,37
Procambarus acutus,15747,13,22,2,37
Stolephorus commersonnii,16734,13,22,2,37
Echinothrix diadema,15712,13,22,2,37
Salmacis sphaeroides,15762,13,22,2,37
Entylia carinata,15662,13,22,2,37
Pycnarmon lactiferalis,15219,13,22,2,37
Cheilopogon doederleinii,16525,13,22,2,37
Chaetobranchopsis bitaeniatus,16610,13,22,2,37
Bujurquina mariae,16540,13,22,2,37
Chrysoporthe cubensis,89084,35,27,2,64
Chrysoporthe austroafricana,190834,94,28,2,124
Chrysoporthe deuterocubensis,124412,64,27,2,93
Hericium coralloides,72961,35,26,2,63
Sakuraeolis japonica,15059,13,22,2,37
Corallina officinalis,26504,23,26,2,51
Yamagishiella unicocca,30876,12,3,12,27
Isospora manorinae,6223,3,0,26,29
Spongospora subterranea,37699,30,24,2,56
Pseudogymnoascus destructans,32181,15,29,2,46
Argas brumpti,14516,13,22,2,37
Ornithodoros zumpti,14434,13,22,2,37
Potamilus alatus,16560,14,22,2,38
Pseudoplatystoma reticulatum,16576,12,22,2,36
Hoplias intermedius,16629,13,22,2,37
Junonia iphita,14957,13,22,2,37
Helice latimera,16246,13,22,2,37
Clistocoeloma sinense,15706,13,22,2,37
Longidorus vineacola,13519,12,22,2,36
Paralongidorus litoralis,12763,12,20,2,34
Xiphinema rivesi,12624,12,21,2,35
Xiphinema pachtaicum,12489,12,18,2,32
Apriona swainsoni,15412,13,22,2,37
Bison schoetensacki,16325,13,22,2,37
Graphosoma rubrolineatum,15633,13,22,2,37
Hoolock leuconedys,16511,13,22,2,37
Hoolock leuconedys x Hoolock tianxing,16514,13,22,2,37
Hoolock tianxing,16511,13,22,2,37
Hoolock hoolock,16495,13,22,2,37
Scomberomorus sierra,16699,13,22,2,37
Aporia bieti,15147,13,22,2,37
Aporia hippia,15154,13,22,2,37
Aporia martineti,15192,13,22,2,37
Mesapia peloria,15159,13,22,2,37
Nothoaspis amazoniensis,14416,13,22,2,37
Bolbometopon muricatum,16788,13,22,2,37
Petaurista yunanensis,16620,13,22,2,37
Sinopodisma houshana,15818,13,22,2,37
Sinopodisma wulingshanensis,15872,13,22,2,37
Otolithes ruber,16589,13,22,2,37
Lamna nasus,16697,13,22,2,37
Enteromius pobeguini,16933,13,22,2,37
Oreichthys crenuchoides,16894,13,22,2,37
Puntius sahyadriensis,16798,13,22,2,37
Hypselobarbus thomassi,16601,13,22,2,37
Sarcocheilichthys biwaensis,16665,13,22,2,37
Saurogobio immaculatus,16988,13,22,2,37
Pachychilon pictum,16602,13,22,2,37
Notropis imeldae,16709,13,22,2,37
Dionda episcopa,16808,13,22,2,37
Luxilus chrysocephalus,16718,13,22,2,37
Nocomis biguttatus,16650,13,22,2,37
Notropis atherinoides,16710,13,22,2,37
Opsopoeodus emiliae,16696,13,22,2,37
Acrocheilus alutaceus,16592,13,22,2,37
Cyprinella galactura,16714,13,22,2,37
Hybopsis lineapunctata,16975,13,22,2,37
Lavinia exilicauda,16602,13,22,2,37
Luxilus cornutus,16717,13,22,2,37
Lythrurus ardens,16701,13,22,2,37
Lythrurus fumeus,16703,13,22,2,37
Lythrurus lirus,16705,13,22,2,37
Lythrurus umbratilis,16696,13,22,2,37
Macrhybopsis meeki,16926,13,22,2,37
Nocomis asper,16655,13,22,2,37
Notropis bifrenatus,16804,13,22,2,37
Pteronotropis hypselopterus,16710,13,22,2,37
Notropis telescopus,16840,13,22,2,37
Pimephales notatus,16711,13,22,2,37
Pogonichthys macrolepidotus,16649,13,22,2,37
Rhinichthys atratulus,16651,13,22,2,37
Rhinichthys cataractae,16655,13,22,2,37
Richardsonius balteatus,16646,13,22,2,37
Semotilus atromaculatus,16623,13,22,2,37
Notropis chrosomus,16718,13,22,2,37
Opsariichthys evolans,16616,13,22,2,37
Opsariichthys pachycephalus,16606,13,22,2,37
Sinibotia pulchra,16568,13,22,2,37
Syncrossus hymenophysa,16513,13,22,2,37
Neohomaloptera johorensis,16565,13,22,2,37
Homaloptera ocellata,16577,13,22,2,37
Barbucca diabolica,16540,13,22,2,37
Homaloptera confuzona,16565,13,22,2,37
Serpenticobitis octozona,16561,13,22,2,37
Homalopteroides smithi,16559,13,22,2,37
Acanthocobitis botia,16660,13,22,2,37
Acanthocobitis zonalternans,16642,13,22,2,37
Micronemacheilus cruciatus,16574,13,22,2,37
Lobocheilos melanotaenia,16592,13,22,2,37
Epalzeorhynchos frenatus,16457,13,22,2,37
Labeo coubie,16605,13,22,2,37
Cirrhinus cirrhosus,16588,13,22,2,37
Microphysogobio amurensis,16599,13,22,2,37
Pluvialis fulva,16854,12,22,2,36
Ninox strenua,16206,13,22,2,37
Agelena silvatica,14776,13,22,2,37
Triplophysa pappenheimi,16572,13,22,2,37
Xenus cinereus,16817,13,22,2,37
Tringa ochropus,16906,13,22,2,37
Unio crassus,15781,14,22,2,38
Decma fissa,16122,13,22,2,37
Hexacentrus japonicus,16120,13,22,2,37
Zichya baranovi,15645,13,22,2,37
Loxoblemmus doenitzi,15396,13,22,2,37
Metrioptera bonneti,16256,13,22,2,37
Conanalus pieli,15820,13,22,2,37
Conocephalus melaenus,15852,13,22,2,37
Diestrammena asynamora,15309,13,22,2,37
Ruspolia lineosa,16110,13,22,2,37
Lipotactes tripyrga,15949,13,22,2,37
Phyllomimus sinicus,15692,13,22,2,37
Hexacentrus unicolor,15752,13,22,2,37
Haematortyx sanguiniceps,16692,13,22,2,37
Lagopus muta,16683,13,22,2,37
Vespa orientalis,16101,13,22,2,37
Takifugu rubripes x Takifugu flavidus,16447,13,22,2,37
Homoiodoris japonica,14601,13,22,2,37
Paraplea frontalis,14143,13,22,2,37
Macroscytus gibbulus,14620,13,22,2,37
Helotrephes sp. NKMT027,15130,13,22,2,37
Cerion uva,15043,13,22,2,37
Ephelotermes melachoma,14950,13,22,2,37
Nasutitermes diabolus,14949,13,22,2,37
Microcerotermes newmani,14950,13,22,2,37
Alyscotermes kilimandjaricus,14935,13,22,2,37
Nasutitermes longirostris,14950,13,22,2,37
Pseudacanthotermes spiniger,14950,13,22,2,37
Agnathotermes crassinasus,14950,13,22,2,37
Nasutitermes banksi,14949,13,22,2,37
Odontotermes obesus,14950,13,22,2,37
Odontotermes hainanensis,14950,13,22,2,37
Bulbitermes makhamensis,14950,13,22,2,37
Macrotermes malaccensis,14949,13,22,2,37
Apilitermes longiceps,14910,13,22,2,37
Patawatermes nigripunctatus,14950,13,22,2,37
Cubitermes fulvus,14950,13,22,2,37
Nasutitermes matangensis,14950,13,22,2,37
Odontotermes mathuri,14950,13,22,2,37
Microcerotermes crassus,14950,13,22,2,37
Hypotermes makhamensis,14950,13,22,2,37
Amitermes capito,14950,13,22,2,37
Prohamitermes mirabilis,14950,13,22,2,37
Nasutitermes graveolus,14950,13,22,2,37
Crepititermes verruculosus,14950,13,22,2,37
Nasutitermes lujae,14950,13,22,2,37
Termes rostratus,14950,13,22,2,37
Constrictotermes cyphergaster,14950,13,22,2,37
Nasutitermes octopilis,14934,13,22,2,37
Macrotermes carbonarius,14853,13,22,2,37
Leucopitermes leucops,14950,13,22,2,37
Orientotermes emersoni,14950,13,22,2,37
Termes fatalis,14950,13,22,2,37
Macrotermes falciger,14950,13,22,2,37
Tumulitermes recalvus,14950,13,22,2,37
Tuberculitermes bycanistes,14950,13,22,2,37
Neocapritermes angusticeps,14950,13,22,2,37
Macrotermes vitrialatus,14950,13,22,2,37
Cornitermes pugnax,14950,13,22,2,37
Cubitermes oblectatus,14950,13,22,2,37
Araujotermes parvellus,14950,13,22,2,37
Labritermes buttelreepeni,14937,13,22,2,37
Bulbitermes laticephalus,14897,13,22,2,37
Nasutitermes longipennis,14950,13,22,2,37
Odontotermes minutus,14950,13,22,2,37
Amitermes meridionalis,14950,13,22,2,37
Furculitermes winifredae,14950,13,22,2,37
Euhamitermes hamatus,14918,13,22,2,37
Microcerotermes baluchistanicus,14950,13,22,2,37
Silvestritermes heyeri,14950,13,22,2,37
Microcerotermes fuscotibialis,14950,13,22,2,37
Ophiotermes mirandus,14950,13,22,2,37
Ateuchotermes retifaciens,14884,13,22,2,37
Havilanditermes proatripennis,14950,13,22,2,37
Proboscitermes tubuliferus,14949,13,22,2,37
Microtermes obesi,14907,13,22,2,37
Trichotermes ducis,14950,13,22,2,37
Hospitalitermes hospitalis,14950,13,22,2,37
Amitermes dentatus,14950,13,22,2,37
Ophiotermes grandilabius,14950,13,22,2,37
Pseudacanthotermes militaris,14950,13,22,2,37
Macrotermes annandalei,14950,13,22,2,37
Allodontermes schultzei,14932,13,22,2,37
Nasutitermes neoparvus,14950,13,22,2,37
Promirotermes pygmaeus,14950,13,22,2,37
Furculitermes soyeri,14950,13,22,2,37
Jugositermes tuberculatus,14950,13,22,2,37
Microcerotermes havilandi,14950,13,22,2,37
Mirocapritermes connectens,14950,13,22,2,37
Cornitermes cumulans,14950,13,22,2,37
Oriensubulitermes inanis,14950,13,22,2,37
Occasitermes occasus,14950,13,22,2,37
Aciculitermes aciculatus,14950,13,22,2,37
Planicapritermes planiceps,14902,13,22,2,37
Spinitermes trispinosus,14950,13,22,2,37
Anhangatermes macarthuri,14950,13,22,2,37
Nasutitermes similis,14950,13,22,2,37
Longustitermes manni,14950,13,22,2,37
Globitermes globosus,14950,13,22,2,37
Cylindrotermes parvignathus,14950,13,22,2,37
Cavitermes tuberosus,14950,13,22,2,37
Tumulitermes pastinator,14950,13,22,2,37
Amalotermes phaeocephalus,14950,13,22,2,37
Orthotermes mansuetus,14894,13,22,2,37
Embiratermes brevinasus,14950,13,22,2,37
Atlantitermes snyderi,14950,13,22,2,37
Sphaerotermes sphaerothorax,14950,13,22,2,37
Microcerotermes nervosus,14945,13,22,2,37
Lophotermes septentrionalis,14950,13,22,2,37
Odontotermes javanicus,14950,13,22,2,37
Aciculitermes maymyoensis,14950,13,22,2,37
Nasutitermes arborum,14950,13,22,2,37
Polyspathotermes sulcifrons,14950,13,22,2,37
Macrotermes gilvus,14950,13,22,2,37
Rubeotermes jheringi,14898,13,22,2,37
Pericapritermes dolichocephalus,14950,13,22,2,37
Crenetermes albotarsalis,14911,13,22,2,37
Postsubulitermes parviconstrictus,14884,13,22,2,37
Nasutitermes exitiosus,14950,13,22,2,37
Foraminitermes rhinoceros,14946,13,22,2,37
Nasutitermes latifrons,14950,13,22,2,37
Inquilinitermes inquilinus,14950,13,22,2,37
Procapritermes martyni,14950,13,22,2,37
Anoplotermes janus,14778,13,22,2,37
Termes comis,14950,13,22,2,37
Acidnotermes praus,14913,13,22,2,37
Anoplotermes parvus,14914,13,22,2,37
Amitermes obeuntis,14949,13,22,2,37
Orthotermes depressifrons,14949,13,22,2,37
Protermes prorepens,14949,13,22,2,37
Macrotermes muelleri,14950,13,22,2,37
Furculitermes longilabius,14950,13,22,2,37
Humutermes krishnai,14902,13,22,2,37
Odontotermes longignathus,14950,13,22,2,37
Furculitermes cubitalis,14949,13,22,2,37
Astalotermes murcus,14950,13,22,2,37
Microcerotermes progrediens,14950,13,22,2,37
Hirtitermes hirtiventris,14950,13,22,2,37
Acholotermes chirotus,14950,13,22,2,37
Cephalotermes rectangularis,14949,13,22,2,37
Patawatermes turricola,14950,13,22,2,37
Procubitermes undulans,14950,13,22,2,37
Globitermes sulphureus,14950,13,22,2,37
Ruptitermes arboreus,14846,13,22,2,37
Coatitermes kartaboensis,14950,13,22,2,37
Microcerotermes serrula,14950,13,22,2,37
Thoracotermes macrothorax,14950,13,22,2,37
Compositermes vindai,14950,13,22,2,37
Noditermes cristifrons,14950,13,22,2,37
Nasutitermes macrocephalus,14950,13,22,2,37
Bulbitermes singaporiensis,14950,13,22,2,37
Atlantitermes oculatissimus,14904,13,22,2,37
Ephelotermes taylori,14950,13,22,2,37
Rhinotergum shaoguanense,13646,13,22,2,37
Myotis bechsteinii,17151,13,22,2,37
Ptychobarbus chungtienensis,16970,13,22,2,37
Euschemon rafflesia,15447,13,22,2,37
Limenitis doerriesi,15233,13,22,2,37
Limenitis sydyi,15200,13,22,2,37
Limenitis moltrechti,15178,13,22,2,37
Limenitis amphyssa,15164,13,22,2,37
Delphinapterus leucas,16386,13,22,2,37
Haematopus ostralegus,16798,13,22,2,37
Gnathostoma nipponicum,14093,12,22,2,36
Bubalus depressicornis,16357,13,22,2,37
Coccocarpia palmicola,73992,16,21,2,39
Fomitopsis palustris,63479,33,26,2,61
Sargassum spinuligerum,34891,37,25,3,65
Diplostephium hartwegii,277718,35,21,3,59
Numida meleagris,16785,13,22,2,37
Mus musculus,16299,13,22,2,37
Mus terricolor,16310,13,22,2,37
Danio rerio,16596,13,22,2,37
Rattus norvegicus,16313,13,22,2,37
Homo heidelbergensis,16568,13,22,2,37
Chionodraco myersi,16942,12,21,2,35
Unio delphinus,15762,14,22,2,38
Pollicipes polymerus,15634,13,24,2,39
Desmophyllum dianthus,16310,12,2,2,16
Chlorocebus aethiops x Chlorocebus pygerythrus,16388,13,22,2,37
Chlorocebus djamdjamensis,16443,13,22,2,37
Campephilus imperialis,16858,13,22,2,37
Brahmaea hearseyi,15442,13,22,2,37
Pachliopta aristolochiae,15232,13,22,2,37
Megaleporinus elongatus,16774,13,22,2,37
Rhombodera brachynota,16616,13,22,2,37
Hierodula patellifera,16999,13,22,2,37
Rhombodera valida,16308,13,22,2,37
Macrotermes yunnanensis,15965,13,22,2,37
Ancylostoma tubaeforme,13730,12,22,2,36
Ichthyomyzon gagei,16359,13,22,2,37
Ellobium chinense,13979,13,21,2,36
Curculio davidi,16852,13,22,2,37
Thymallus baicalolenensis,16662,13,22,2,37
Glaucidium cuculoides,17392,13,22,2,37
Daphnia galeata,16339,13,22,2,37
Nihonotrypaea harmandi,15272,13,22,2,37
Bryopa lata,31969,13,21,2,36
Euciroa cf. queenslandica STW-2017,15042,13,22,2,37
Lyonsia norwegica,14673,13,23,2,38
Myadora brevis,19292,13,24,2,39
Tropidomya abbreviata,16829,13,22,2,37
Laternula truncata,16363,13,22,2,37
Rhinolophus thomasi,16899,13,22,2,37
Dicrostonyx hudsonius,16338,13,22,2,37
Dicrostonyx groenlandicus,16341,13,22,2,37
Meriones tamariscinus,16389,13,22,2,37
Sarothrura ayresi,16767,12,22,2,36
Papilio protenor,15268,13,22,2,37
Sinularia cf. cruciata GS-2016,18730,14,1,2,17
Hippocampus queenslandicus,16527,13,22,2,37
Anisakis pegreffii,14002,12,22,2,36
Mustela itatsi,16027,13,22,2,37
Acanthocepola krusensternii,16415,13,22,2,37
Epigonus denticulatus,16515,13,22,2,37
Synagrops japonicus,16803,13,22,2,37
Bedotia geayi,16527,13,22,2,37
Dermogenys pusilla,16529,13,22,2,37
Hoplichthys gilberti,16504,13,22,2,37
Lates japonicus,16590,13,22,2,37
Uranoscopus japonicus,17878,13,22,2,37
Plesiops nakaharae,16961,13,22,2,37
Bathyclupea megaceps,16850,13,22,2,37
Acanthaphritis unoorum,16620,13,22,2,37
Trichonotus setiger,16595,13,22,2,37
Indopacetus pacificus,16341,13,22,2,37
Nibea mitsukurii,16498,13,22,2,37
Bovichtus argentinus,16903,13,22,2,37
Macropodus chinensis,16497,13,22,2,37
Garrulax formosus,17869,13,22,2,37
Papilio dardanus,15349,13,22,0,35
Papilio rex,15239,13,22,0,35
Ciona robusta,14790,13,24,2,39
Trochalopteron elliotii,17873,13,22,2,37
Gracilaria changii,25729,25,23,2,50
Bryoria tenuis,84295,12,17,2,31
Gomphillus americanus,28370,13,26,2,41
Ophiocordyceps sinensis,157539,88,27,2,117
Fucus distichus,36400,38,23,3,64
Phyllopsora corallina,39591,13,23,2,38
Pharyngomonas kirbyi,75717,44,26,2,72
Abraxas suspecta,15537,13,22,2,37
Styloperla spinicercia,16129,13,22,2,37
Babesia microti strain RI,10547,3,0,8,11
Paragabara curvicornuta,15532,13,22,2,37
Merops viridis,18295,13,22,2,37
Dicrostonyx torquatus,16340,13,22,2,37
Liobagrus styani,16515,13,22,2,37
Lycodes tanakae,16594,13,22,2,37
Gymnocanthus intermedius,16639,13,22,2,37
Gymnocanthus herzensteini,16691,13,22,2,37
Hemilepidotus gilberti,16907,13,22,2,37
Anaulaciulus koreanus,14916,13,22,2,37
Diodon hystrix,16512,13,22,2,37
Diodon liturosus,16514,13,22,2,37
Capnia zijinshana,16310,13,22,2,37
Junonia litoralis,15177,13,22,2,37
Junonia vestina,15224,13,22,2,37
Bathylychnops exilis,16444,13,22,2,37
Dolichopteryx minuscula,16875,13,22,2,37
Hypophthalmichthys nobilis x Hypophthalmichthys molitrix,16616,13,22,2,37
Epinephelus akaara x Epinephelus lanceolatus,16795,13,22,2,37
Xiphister atropurpureus,16518,13,22,2,37
Choroedocus violaceipes,15694,13,22,2,37
Aiolopus thalassinus,15753,13,22,2,37
Cromileptes altivelis x Epinephelus lanceolatus,16503,13,22,2,37
Burara striata,15327,13,22,2,37
Spirula spirula,15472,13,21,2,36
Senga ophiocephalina,13816,12,22,2,36
Lepilemur ankaranensis,17157,13,22,2,37
Lepilemur fleuretae,16879,13,22,2,37
Lepilemur leucopus,16753,13,22,2,37
Lepilemur edwardsi,16923,13,22,2,37
Lepilemur dorsalis,17078,13,22,2,37
Lepilemur randrianasoloi,16993,13,22,2,37
Lepilemur petteri,16789,13,22,2,37
Lepilemur otto,16769,13,22,2,37
Lepilemur milanoii,17057,13,22,2,37
Lepilemur betsileo,16916,13,22,2,37
Lepilemur septentrionalis,16935,13,22,2,37
Lepilemur mittermeieri,17077,13,22,2,37
Lepilemur grewcockorum,17052,13,22,2,37
Lepilemur aeeclis,16941,13,22,2,37
Lepilemur seali,16771,13,22,2,37
Lepilemur wrightae,16943,13,22,2,37
Lepilemur ahmansonorum,17179,13,22,2,37
Lepilemur sahamalazensis,16773,13,22,2,37
Lepilemur tymerlachsoni,16780,13,22,2,37
Lepilemur jamesorum,16845,13,22,2,37
Lepilemur scottorum,17038,13,22,2,37
Lepilemur hollandorum,17018,13,22,2,37
Lepilemur microdon,17050,13,22,2,37
Clostera anachoreta,15456,13,22,2,37
Gallinago stenura,16899,13,22,2,37
Schistura sikmaiensis,16581,13,22,2,37
Squalus brevirostris,16734,13,22,2,37
Paramuricea clavata,18669,14,1,2,17
Paramuricea macrospina,18921,14,1,2,17
Thyestilla gebleri,15505,13,22,2,37
Sarcocheilichthys kiangsiensis,16672,13,22,2,37
Limenitis helmanni,15178,13,22,2,37
Barbodes binotatus,16573,13,22,2,37
Phaneroptera gracilis,18255,13,22,2,37
Phaneroptera nigroantennata,16832,13,22,2,37
Echinometra mathaei,15699,13,22,2,37
Heterocentrotus mammillatus,15729,13,22,2,37
Mespilia globulus,15719,13,22,2,37
Tripneustes gratilla,15720,13,22,2,37
Narcine brasiliensis,16997,13,22,2,37
Narcine bancroftii,16971,13,22,2,37
Oryzias curvinotus,16676,13,22,2,37
Schistura fasciolata,16560,13,22,2,37
Bavayia robusta,17271,13,22,2,37
Macrosteles quadrilineatus,16626,13,22,2,37
Orcula dolium,14063,13,22,2,37
Pontoscolex corethrurus,14835,13,22,2,37
Huso dauricus x Acipenser schrenckii,16693,13,22,2,37
Haemaphysalis concinna,14675,13,22,2,37
Sinocrossocheilus bamaensis,16594,13,22,2,37
Trachypithecus poliocephalus,16556,13,22,2,37
Khawia sinensis,13759,12,22,2,36
Muscina angustifrons,16316,13,22,2,37
Sorex roboratus,17153,13,22,2,37
Amazona ventralis,18571,13,22,2,37
Protegira songi,15410,13,22,2,37
Stoneobryum mirum,104345,40,24,3,67
Leptogium hirsutum,120920,18,21,2,41
Cypseloides fumigatus,16850,13,22,2,37
Beauveria caledonica,38316,27,26,1,54
Ozobranchus jantseanus,14864,13,22,2,37
Utricularia reniformis,857234,2190,25,3,2218
Aquatica wuhana,16186,13,22,2,37
Gossypium arboreum,687482,39,28,7,74
Gossypium davidsonii,644311,36,26,7,69
Gossypium trilobum,644460,36,26,7,69
Carcharodon carcharias,16744,13,22,2,37
Diploscapter coronatus,13378,12,22,2,36
Populus davidiana,779361,53,22,3,78
Thorea hispida,25380,25,22,2,49
Sclerotinia sclerotiorum 1980 UF-70,128852,45,33,0,78
Aedes aegypti,16790,13,23,2,38
Graphium leechi,15836,13,22,2,37
Periplaneta australasiae,15605,13,22,2,37
Neostylopyga rhombifolia,15711,13,22,2,37
Neotrigonia margaritacea,16739,13,22,2,37
Mutela dubia,16168,13,22,2,37
Echyridella menziesii,16031,14,22,2,38
Cumberlandia monodonta,16099,14,23,2,39
Solemya elarraichensis,15767,13,22,2,37
Petrasma pervernicosa,16554,13,22,2,37
Solemya velesiana,16030,13,22,2,37
Pseudunio marocanus,16001,13,22,2,37
Anastrepha fraterculus,16739,13,22,2,37
Favites pentagona,18006,13,5,2,20
Acrossocheilus jishouensis,16587,13,22,2,37
Acrossocheilus spinifer,16591,13,22,2,37
Acrossocheilus wuyiensis,16594,13,22,2,37
Nembrotha kubaryana,14395,13,22,2,37
Glyptothorax cavia,16529,13,22,2,37
Cestrotus liui,16171,13,22,2,37
Pachycerina decemlineata,16286,13,22,2,37
Spaniocelyphus pilosus,16426,13,22,2,37
Kiwa tyleri,16865,13,22,2,37
Labiotermes labralis,15953,13,22,2,37
Embiratermes neotenicus,15868,13,22,2,37
Gammarus fossarum,15989,13,22,2,37
Lepidotrigla microptera,16610,13,22,2,37
Megaleporinus obtusidens,16682,13,22,2,37
Paratomella rubra,14954,13,22,2,37
Archaphanostoma ylvae,16619,12,22,2,36
Isodiametra pulchra,18725,11,22,2,35
Centropyge nox,16871,13,22,2,37
Odorrana wuchuanensis,18256,13,22,2,37
Odorrana hainanensis,17986,13,22,2,37
Parasa consocia,15296,13,22,2,37
Sinochlora szechwanensis,18051,13,22,2,37
Helicana wuana,16359,13,22,2,37
Zelandoperla fenestrata,16385,13,22,2,37
Kryptopterus bicirrhis,16662,13,22,2,37
Cottus volki,16536,13,22,2,37
Cottus amblystomopsis,16528,13,22,2,37
Cyathostomum catinatum,13838,12,22,2,36
Cylicostephanus minutus,13826,12,22,2,36
Poteriostomum imparidentatum,13817,12,22,2,36
Paramesotriton chinensis,16361,13,22,2,37
Nauphoeta cinerea,15923,13,22,2,37
Squatina squatina,16689,13,22,2,37
Thermophis shangrila,17407,13,22,2,37
Chelidonichthys kumu,16495,13,22,2,37
Aquatica ficta,16836,13,22,2,37
Opisthopterus tardoore,16852,13,22,2,37
Dussumieria elopsoides,16819,13,22,2,37
Amblygaster sirm,17049,13,22,2,37
Verticillium alfalfae VaMs.102,29493,17,27,0,44
Gaeumannomyces tritici R3-111a-1,105383,0,0,0,0
Gaeumannomyces tritici R3-111a-1,32120,0,0,0,0
Gaeumannomyces tritici R3-111a-1,8714,0,0,0,0
Gaeumannomyces tritici R3-111a-1,4300,0,0,0,0
Histoplasma capsulatum NAm1,1032,0,0,0,0
Histoplasma capsulatum NAm1,1093,0,0,0,0
Histoplasma capsulatum NAm1,6949,0,0,0,0
Histoplasma capsulatum NAm1,18217,0,0,0,0
Histoplasma capsulatum NAm1,14560,0,0,0,0
Esteya vermicola,46507,14,24,2,40
Stratiotes aloides,349058,28,8,3,39
Zostera marina,191481,25,10,3,38
Sheathia arcuata,25086,23,19,2,44
Compsopogon caeruleus,26807,21,22,2,45
Thryssa dussumieri,16920,13,22,2,37
Mastacembelus erythrotaenia,16493,13,22,2,37
Ancylostoma ceylanicum,13660,12,22,2,36
Yasuhikotakia modesta,16588,13,22,2,37
Atherinosoma microstoma,16573,13,22,2,37
Craterocephalus eyresii,16602,13,22,2,37
Aeluroscalabotes felinus,18974,13,22,2,37
Cyrtopodion scabrum,16994,13,22,2,37
Ptyodactylus guttatus,17662,13,22,2,37
Gonatodes albogularis,16830,13,22,2,37
Halcyon pileata,17612,13,22,2,37
Colletotrichum salicis,33950,15,29,2,46
Arthrinium arundinis,48975,20,23,2,45
Hibiscus cannabinus,569915,37,29,3,69
Imshaugia aleurites,32029,14,22,2,38
Spinacia oleracea,329613,29,23,3,55
Lagerstroemia indica,333948,36,16,3,55
Pithomyces chartarum,68926,37,26,2,65
Ulva pertusa,69333,43,26,2,71
Phytophthora nicotianae,37561,38,25,2,65
Hypogymnia vittata,38888,16,25,2,43
Coprinopsis cinerea okayama7#130,42448,16,24,2,42
Pternoscirta caliginosa,15598,12,22,2,36
Elephas antiquus,16105,13,22,2,37
Hermetia illucens,15698,13,22,2,37
Meroptera pravella,15260,13,22,2,37
Caenorhabditis remanei,13610,12,22,2,36
Caenorhabditis brenneri,14212,12,22,2,36
Caenorhabditis plicata,14248,12,22,2,36
Caenorhabditis angaria,13596,12,22,2,36
Caenorhabditis doughertyi,13719,12,22,2,36
Caenorhabditis virilis,13661,12,22,2,36
Caenorhabditis wallacei,13705,12,22,2,36
Caenorhabditis nouraguensis,13786,12,22,2,36
Caenorhabditis macrosperma,13633,12,22,2,36
Caenorhabditis afra,14245,12,22,2,36
Caenorhabditis castelli,13655,12,22,2,36
Macrostomum lignano,14193,13,21,2,36
Stenostomum sthenum,16944,14,32,3,49
Segonzacia mesatlantica,15521,13,22,2,37
Nurudea shiraii,15389,13,22,2,37
Gekko hokouensis,17769,13,22,2,37
Poecilia latipinna,16533,13,22,2,37
Poecilia mexicana,16541,13,22,2,37
Zeylanicobdella arugamensis,16161,13,22,2,37
Floraphis choui,15308,13,22,2,37
Nurudea ibofushi,16054,13,22,2,37
Meitanaphis flavogallis,16150,13,22,2,37
Nurudea yanoniella,15858,13,23,2,38
Baizongia pistaciae,15602,13,22,2,37
Meitanaphis elongallis,16191,13,22,2,37
Floraphis meitanensis,15301,13,22,2,37
Typhlatya taina,15790,13,22,2,37
Typhlatya pearsei,15798,13,22,2,37
Typhlatya iliffei,15926,13,22,2,37
Typhlatya galapagensis,16430,13,22,2,37
Typhlatya mitchelli,15814,13,22,2,37
Stygiocaris lancifera,15787,13,22,2,37
Typhlatya monae,16007,13,22,2,37
Typhlopatsa pauliani,15824,13,22,2,37
Typhlatya consobrina,15758,13,22,2,37
Typhlatya dzilamensis,15892,13,22,2,37
Typhlatya garciai,15318,13,22,2,37
Typhlatya arfeae,15887,13,22,2,37
Stygiocaris stylifera,15812,13,22,2,37
Halocaridinides fowleri,15977,13,22,2,37
Kryptopterus vitreolus,16662,13,22,2,37
Pteranabropsis carli,15932,13,22,2,37
Gigantidas platifrons,17435,12,27,2,41
Modiolus philippinarum,16389,12,22,2,36
Himantopus himantopus,17378,13,22,2,37
Maja crispata,16592,13,22,2,37
Maja squinado,16598,13,22,2,37
Lagenorhynchus obliquidens,16392,13,22,2,37
Calotomus japonicus,17199,13,22,2,37
Pseudogobius fulvicaudus,16495,13,22,2,37
Meghimatium bilineatum,13972,13,22,2,37
Caryophyllaeus brachycollis,14504,12,22,2,36
Ampelophaga rubiginosa,15282,13,22,2,37
Elysia cornigera,14118,13,22,2,37
Elysia timida,14088,13,22,2,37
Sphyrna mokarran,16719,13,22,2,37
Etheostoma okaloosae,16616,13,22,2,37
Eurycea cirrigera,16759,13,22,2,37
Deroceras reticulatum,14048,13,22,2,37
Ceratitis fasciventris,16017,13,22,2,37
Pseudobagrus tenuis,16535,13,22,2,37
Neodon sikimensis,16330,13,22,2,37
Archichauliodes deceptor,15798,13,22,2,37
Hediste diadroma,15765,13,22,2,37
Anoplocnemis curvipes,16345,13,22,2,37
Anaphothrips obscurus,14890,12,22,2,36
Triatoma infestans,17301,13,22,2,37
Pteranabropsis carnarius,16119,13,22,2,37
Pteranabropsis crenatis,16099,13,22,2,37
Microcebus arnholdi,16832,13,22,2,37
Microcebus tanosi,16649,13,22,2,37
Microcebus ravelobensis,16652,13,22,2,37
Microcebus myoxinus,16842,13,22,2,37
Microcebus griseorufus,16719,13,22,2,37
Microcebus bongolavensis,16658,13,22,2,37
Microcebus tavaratra,16646,13,22,2,37
Microcebus sambiranensis,16674,13,22,2,37
Microcebus rufus,16819,13,22,2,37
Microcebus mittermeieri,16687,13,22,2,37
Microcebus jollyae,16794,13,22,2,37
Vaejovis smithi,14492,13,22,2,37
Lagopus lagopus,16677,13,22,2,37
Peromyscus polionotus,16413,13,22,2,37
Sigmodon hispidus,16394,13,22,2,37
Dremomys pernyi,16573,13,22,2,37
Zoanthus sansibaricus,20972,13,1,2,16
Palythoa heliodiscus,20841,13,1,2,16
Margarya melanioides,17083,13,22,2,37
Peromyscus attwateri,16593,13,22,2,37
Neotoma mexicana,16653,13,22,2,37
Podomys floridanus,16486,13,22,2,37
Peromyscus aztecus,16656,13,22,2,37
Reithrodontomys mexicanus,16606,13,22,2,37
Peromyscus pectoralis,16692,13,22,2,37
Isthmomys pirrensis,16512,13,22,2,37
Microcebus danfossi,16809,13,22,2,37
Microcebus mamiratra,16735,13,22,2,37
Microcebus lehilahytsara,16825,13,22,2,37
Microcebus margotmarshae,16821,13,22,2,37
Cheirogaleus crossleyi,16622,13,22,2,37
Cheirogaleus sibreei,16440,13,22,2,37
Mirza zaza,16777,13,22,2,37
Phaner electromontis,16914,13,22,2,37
Phaner pallescens,16577,13,22,2,37
Phaner parienti,16626,13,22,2,37
Dactylogyrus lamellatus,15187,12,22,2,36
Peromyscus melanophrys,16739,13,22,2,37
Habromys ixtlani,16515,13,22,2,37
Peromyscus megalops,16821,13,22,2,37
Peromyscus crinitus,16672,13,22,2,37
Neotomodon alstoni,16776,13,22,2,37
Rattus baluensis,16312,13,22,2,37
Napothera epilepidota,17913,13,22,2,37
Lymantria umbrosa,15642,13,22,2,37
Vanmanenia stenosoma,16560,13,22,2,37
Microcebus berthae,16904,13,22,2,37
Microcebus simmonsi,16623,13,22,2,37
Allocebus trichotis,16863,13,22,2,37
Breviscolex orientalis,14011,12,22,2,36
Atractolytocestus huronensis,15130,12,22,2,36
Agkistrodon contortrix,16269,13,22,2,37
Cheirogaleus major,16596,13,22,2,37
Mirza coquereli,17066,13,22,2,37
Megaceryle lugubris,17223,13,22,2,37
Ambloplites rupestris,16659,13,22,2,37
Etheostoma caeruleum,16588,13,22,2,37
Leptogorgia capverdensis,18722,14,1,2,17
Eugorgia mutabilis,19157,14,1,2,17
Eunicella albicans,19175,14,1,2,17
Eunicella cavolini,19316,14,1,2,17
Pacifigorgia cairnsi,19156,14,1,2,17
Leptogorgia alba,18848,14,1,2,17
Leptogorgia sarmentosa,18722,14,1,2,17
Sporophila maximiliani,16801,13,22,2,37
Acanthoscelides obtectus,16130,13,22,2,37
Laurentaeglyphea neocaledonica,15752,13,22,2,37
Steromphala umbilicaris,16277,13,22,2,37
Durgades nigropicta,15974,13,22,2,37
Japanagallia spinosa,15655,13,22,2,37
Manticora tibialis,16439,13,22,2,37
Nautilus pompilius,15693,12,21,2,35
Kraemeria cunicularia,16682,13,22,2,37
Schismatogobius ampluvinculus,16639,13,22,2,37
Conomurex luhuanus,15799,13,22,2,37
Cerastoderma edule,14947,13,24,2,39
Pseudemydura umbrina,16414,13,22,2,37
Viviparus chui,16392,13,22,2,37
Cipangopaludina chinensis,17009,13,22,2,37
Sinotaia aeruginosa,17013,13,22,2,37
Lates niloticus,16684,13,22,2,37
Psammoperca waigiensis,16623,13,22,2,37
Nemopilema nomurai,17024,13,6,2,21
Rhopilema esculentum,15855,13,5,2,20
Halcyon smyrnensis,17892,13,22,2,37
Prunella fulvescens,16837,13,22,2,37
Myuchelys bellii,16465,13,22,2,37
Rasbora argyrotaenia,16740,13,22,2,37
Cipangopaludina ussuriensis,16596,13,22,2,37
Aquatica lateralis,16719,13,22,2,37
Reduvius tenebrosus,17090,13,22,2,37
Ruditapes decussatus,18995,13,22,2,37
Opegrapha vulgata,38937,19,18,2,39
Ricasolia amplissima,82333,16,29,2,47
Ulva flexuosa,71545,41,27,2,70
Graphis lineola,24945,12,19,2,33
Thermophis baileyi,17355,13,22,2,37
Onchocerca volvulus,13747,12,22,2,36
Saccharomyces eubayanus,63999,9,24,2,35
Platycodon grandiflorus,1249593,33,18,6,57
Bupleurum falcatum,463792,59,19,3,81
Solanum lycopersicum,446257,39,27,5,71
Carassius auratus x Megalobrama amblycephala x Carassius cuvieri,16596,13,22,2,37
Calypogeia integristipula,163057,42,28,3,73
Calypogeia arguta,159061,42,27,3,72
Calypogeia suecica,161960,42,28,3,73
Calypogeia fissa subsp. neogaea,162175,42,28,3,73
Johnius carouna,18752,13,23,2,38
Atrobucca nibe,16842,13,22,2,37
Copadichromis trimaculatus,16581,13,22,2,37
Chilotilapia rhoadesii,16580,13,22,2,37
Cyathochromis obliquidens,16581,13,22,2,37
Schizothorax curvilabiatus,16578,13,22,2,37
Phymata americana,15954,13,21,2,36
Carcinocoris binghami,15344,13,22,2,37
Cnizocoris sinensis,15262,13,22,2,37
Tringa semipalmata,16603,13,22,2,37
Mastomys coucha,16216,13,22,2,37
Bos frontalis,16346,13,22,2,37
Kluyveromyces marxianus DMKU3-1042,46308,11,22,2,35
Steganacarus magnus,13818,13,6,2,21
Helicoverpa assulta,15373,13,22,2,37
Mammut americanum,16467,13,22,2,37
Circus melanoleucos,17749,13,22,2,37
Rana chaochiaoensis,18591,13,22,2,37
Rana kukunoris,18863,13,22,2,37
Rana omeimontis,19934,13,22,2,37
Aquila heliaca,18067,13,22,2,37
Lutra sumatrana,16586,13,22,2,37
Lutrogale perspicillata,16043,13,22,2,37
Sundasciurus brookei,16418,13,22,2,37
Sundasciurus lowii,16308,13,22,2,37
Aonyx cinereus,16154,13,22,2,37
Callosciurus notatus,16599,13,22,2,37
Callosciurus prevostii,16674,13,22,2,37
Callosciurus finlaysonii,16490,13,22,2,37
Sundamys muelleri,16336,13,22,2,37
Leopoldamys sabanus,15975,13,22,2,37
Trichys fasciculata,16328,13,22,2,37
Niviventer cremoriventer,16234,13,22,2,37
Hippocampus sindonis,16500,13,22,2,37
Chlorotocus crassicornis,15935,13,22,2,37
Myocastor coypus,16874,13,22,2,37
Etheostoma tallapoosae,16592,13,22,2,37
Alcedo atthis,17383,13,22,2,37
Baicalia turriformis,15127,13,22,2,37
Godlewskia godlewskia,15224,13,22,2,37
Maackia herderiana,15154,13,22,2,37
Sardinella fijiensis,16695,13,22,2,37
Corvus coronoides,16925,13,22,2,37
Favites abdita,17825,13,2,3,18
Diphyllobothrium stemmacephalum,13716,12,22,2,36
Apis mellifera sahariensis,16569,13,22,2,37
Halosauropsis macrochir,16655,13,22,2,37
Euproctis similis,15437,13,22,2,37
Neanthes glandicincta,16126,13,22,2,37
Pennahia pawak,16408,13,22,2,37
Etheostoma chuckwachatte,16603,13,22,2,37
Etheostoma jessiae,16600,13,22,2,37
Percina crypta,16605,13,22,2,37
Rhipicephalus turanicus,14717,13,22,2,37
Xenograpsus ngatama,16106,13,22,2,37
Xenocypris yunnanensis,16630,13,22,2,37
Triticum aestivum,452526,36,22,9,67
Labichthys carinatus,16683,13,22,2,37
Crocodylus johnsoni,16851,13,22,2,37
Paramecium aurelia,40469,32,3,3,38
Acanthurus lineatus,16532,13,22,2,37
Coccidioides immitis RS,68094,0,0,0,0
Nannizzia gypsea CBS 118893,23539,14,0,0,14
Stemphylium lycopersici,75911,37,28,2,67
[Candida] psychrophila,38445,25,25,2,52
Fusarium commune,47526,18,26,2,46
Megalobrama amblycephala x (Megalobrama amblycephala x Parabramis pekinensis),16623,13,22,2,37
Megalobrama amblycephala x (Megalobrama amblycephala x Megalobrama terminalis),16623,13,22,2,37
Ondatra zibethicus,16348,13,22,2,37
Prosopocoilus confucius,16951,13,22,2,37
Potamotrygon magdalenae,17429,13,22,2,37
Epicauta gorhami,15691,13,22,2,37
Epicauta tibialis,15716,13,22,2,37
Hycleus marcipoli,15923,13,22,2,37
Hycleus phaleratus,16003,13,22,2,37
Mylabris aulica,15758,13,22,2,37
Hospitalitermes medioflavus,14950,13,22,2,37
Sebastes fasciatus,16400,13,22,2,37
Hippocampus jayakari,16520,13,22,2,37
Gyps fulvus,18094,13,22,2,37
Planocera reticulata,14724,12,22,2,36
Laticauda laticaudata,17209,13,22,2,37
Laticauda colubrina,17450,13,22,2,37
Laticauda semifasciata,17170,13,22,2,37
Odontobutis haifengensis,17016,13,22,2,37
Athetis lepigone,15589,13,22,2,37
Nomadacris japonica,15638,13,22,2,37
Traulia minuta,15636,13,22,2,37
Smutsia gigantea,16540,13,22,2,37
Melaphis rhois,15436,13,22,2,37
Dorcadia ioffi,16785,13,22,2,37
Dolichovespula panda,17137,13,22,2,37
Tectus pyramis,18439,13,23,2,38
Mugilogobius myxodermus,16495,13,22,2,37
Sarcophaga misera,14944,13,22,2,37
Gastrolina thoracica,16109,13,22,2,37
Yanocephalus yanonis,15623,13,22,2,37
Charybdis natator,15664,13,22,2,37
Trichoderma hamatum,32763,20,26,2,48
Absidia glauca,63080,28,24,2,54
Corvus corax,16928,13,22,2,37
Placozoan sp. BZ10101,32661,0,24,3,27
Placozoan sp. BZ49,37194,0,24,3,27
Placozoan sp. BZ2423,36699,0,24,3,27
Plasmodium yoelii,5957,3,0,24,27
Solanum pennellii,423596,41,24,5,70
Scaphirhynchus suttkusi,16495,13,22,2,37
Aethina tumida,16576,13,22,2,37
Cottus asper,16511,13,22,2,37
Cottus perifretum,16523,13,22,2,37
Cottus rhenanus,16522,13,22,2,37
Erpobdella japonica,14725,13,22,2,37
Hydromanicus wulaianus,15289,13,22,2,37
Sinodendron yunnanense,16921,13,22,2,37
Moniezia benedeni,13958,12,22,2,36
Tagiades litigiosa,15359,13,24,2,39
Awaous banana,16513,13,22,2,37
Eleotris amblyopsis,16519,13,22,2,37
Eleotris picta,16547,13,22,2,37
Gobiomorus maculatus,16536,13,22,2,37
Hemieleotris latifasciata,16523,13,22,2,37
Sicydium altum,16499,13,22,2,37
Sicydium salvini,16501,13,22,2,37
Lympha mucosa,25191,24,20,2,46
Osteobrama belangeri,16602,13,22,2,37
Ompok bimaculatus,16482,13,22,2,37
Gloydius strauchi,17224,13,22,2,37
Apis nuluensis,15843,13,22,2,37
[Candida] glabrata CBS 138,20063,11,23,2,36
Usnea ceratina,65539,14,20,2,36
Comephorus dybowskii,16527,13,22,2,37
Comephorus baikalensis,16530,13,22,2,37
Spheniscus magellanicus,16546,13,22,2,37
Cladonia rangiferina,59116,18,23,2,43
Castor canadensis,16767,13,22,2,37
Rhodotorula mucilaginosa,47023,31,23,2,56
Gymnocypris scleracanthus,16679,13,22,2,37
Bipolaris cookei,135790,66,30,2,98
Tremella fuciformis,35058,20,23,2,45
Betaphycus gelatinus,25275,24,24,2,50
Eucheuma denticulatum,25327,24,24,2,50
Hippotragus leucophaeus,16505,13,22,2,37
Tachyta nana,16165,13,22,2,37
Hylastes brunneus,15774,13,22,2,37
Anopheles dirus,15406,13,22,2,37
Incoltorrida madagassica,16139,13,22,2,37
Monotoma quadricollis,16064,13,22,2,37
Byturus ochraceus,15143,13,22,2,37
Amara communis,15745,13,22,2,37
Usechus lacerta,15289,13,22,2,37
Hydrochus carinatus,16825,13,22,2,37
Amphizoa insolens,15117,13,22,2,37
Anatis ocellata,17092,13,22,2,37
Silvanus bidentatus,17220,13,22,2,37
Tetratoma fungorum,15089,13,22,2,37
Eucinetus haemorrhoidalis,17954,13,22,2,37
Horatocera niponica,16107,13,22,2,37
Xylosandrus germanus,16099,13,22,2,37
Ips sexdentatus,18579,13,22,2,37
Dryocoetes villosus,15859,13,22,2,37
Xylosandrus crassiusculus,16875,13,22,2,37
Trypophloeus asperatus,17039,13,22,2,37
Trypodendron domesticum,16986,13,22,2,37
Dryocoetes autographus,17055,13,22,2,37
Pityophthorus pubescens,17316,13,22,2,37
Pityogenes bidentatus,18781,13,22,2,37
Hylastes attenuatus,17409,13,22,2,37
Orthotomicus laricis,18887,13,22,2,37
Trypodendron signatum,16909,13,22,2,37
Anisandrus dispar,16665,13,22,2,37
Gnathotrichus materiarius,16871,13,22,2,37
Cyclorhipidion bodoanus,15899,13,22,2,37
Maiestas dorsalis,15352,13,22,2,37
Spheniscus mendiculus,16367,13,22,2,37
Japananus hyalinus,15364,13,22,2,37
Pleuronichthys japonicus,17325,13,22,2,37
Discogobio longibarbatus,16594,13,22,2,37
Paratetraonchoides inermis,14654,12,22,2,36
Myotis dominicensis,16999,13,22,2,37
Myotis evotis,17039,13,22,2,37
Myotis keaysi,17057,13,22,2,37
Myotis oxyotus,17067,13,22,2,37
Myotis riparius,17074,13,22,2,37
Myotis nigricans,17067,13,22,2,37
Myotis yumanensis,17268,13,22,2,37
Myotis auriculus,17289,13,22,2,37
Myotis leibii,16997,13,22,2,37
Myotis thysanodes,17018,13,22,2,37
Myotis atacamensis,17100,13,22,2,37
Myotis horsfieldii,17083,13,22,2,37
Myotis volans,17443,13,22,2,37
Myotis albescens,17126,13,22,2,37
Myotis martiniquensis,17170,13,22,2,37
Atractosteus tristoechus,16290,13,22,2,37
Tadarida teniotis,16869,13,22,2,37
Tadarida latouchei,16784,13,22,2,37
Phaedyma columella,15197,13,22,2,37
Patsuia sinensium,15192,13,22,2,37
Moduza procris,15195,13,22,2,37
Typhlatya miravetensis,15865,13,22,2,37
Spheniscus humboldti,16658,13,22,2,37
Parapolybia crocea,16619,13,22,2,37
Gelochelidon nilotica,16748,13,22,2,37
Mesoclemmys hogei,16513,13,22,2,37
Dendrolimus kikuchii,15422,13,22,2,37
Electrona carlsbergi,18282,13,23,2,38
Amphioctopus marginatus,15719,13,22,2,37
Diaphorina lycii,15112,13,22,2,37
Pteroptyx maipo,16127,13,22,2,37
Argonauta hians,16130,13,22,2,37
Prionoglaris stygia,15685,13,22,2,37
Amphigerontia montivaga,15566,13,22,2,37
Archipsocus nomas,15349,13,22,2,37
Lachesilla anna,16236,13,22,2,37
Speleketor irwini,16849,13,22,2,37
Stimulopalpus japonicus,14904,13,22,2,37
Otocyon megalotis,16431,13,22,2,37
Lepomis auritus,16501,13,22,2,37
Pylodictis olivaris,16508,13,22,2,37
Ameiurus natalis,16513,13,22,2,37
Salvelinus namaycush,16653,13,22,2,37
Coregonus artedi,16820,13,22,2,37
Lonchura leucosticta,16833,13,22,2,37
Lonchura caniceps,16826,13,22,2,37
Lonchura castaneothorax,16823,13,22,2,37
Lonchura flaviprymna,16824,13,22,2,37
Lonchura forbesi,16823,13,22,2,37
Lonchura hunsteini,16823,13,22,2,37
Lonchura grandis x Lonchura castaneothorax,16826,13,22,2,37
Lonchura melaena,16824,13,22,2,37
Lonchura nevermanni,16824,13,22,2,37
Lonchura nigerrima,16826,13,22,2,37
Lonchura spectabilis,16825,13,22,2,37
Lonchura stygia,16826,13,22,2,37
Marshallagia marshalli,13891,12,22,2,36
Mahasena oolona,16119,13,22,2,37
Trichobilharzia szidati,14293,12,22,2,36
Delphinus delphis,16384,13,22,2,37
Picromerus griseus,16338,13,22,2,37
Rhinolophus yunnanensis,16864,13,22,2,37
Acipenser dabryanus x Acipenser schrenckii,16439,13,22,2,37
Saccopteryx leptura,16577,13,22,2,37
Hypselodoris apolegma,14749,13,22,2,37
Parascaris equorum,13899,12,22,2,36
Sarcophaga formosensis,14926,13,22,2,37
Eurythenes maldoror,14976,13,22,2,37
Manis crassicaudata,16576,13,22,2,37
Manis culionensis,16577,13,22,2,37
Dorypteryx domestica,18512,13,22,2,37
Zygosaccharomyces mellis,24335,14,24,2,40
Torulaspora quercuum,33299,17,24,2,43
Torulaspora microellipsoides,34709,14,24,2,40
Naumovozyma dairenensis,46425,14,23,2,39
Kazachstania unispora,29129,15,23,2,40
[Candida] nivariensis,28524,11,23,2,36
[Candida] bracarensis,46138,12,23,2,37
Tor malabaricus,16580,13,22,2,37
Muntiacus putaoensis,16349,13,22,2,37
Botrylloides giganteus,14323,13,24,2,39
Nicotiana attenuata,394341,40,24,4,68
Gossypium thurberi,644395,36,26,7,69
Lepomis punctatus,16512,13,22,2,37
Ancoracysta twista,52735,57,27,3,87
Marchantia paleacea,186609,76,29,3,108
Cherax holthuisi,15889,13,22,2,37
Cherax boesemani,15858,13,22,2,37
Hirsutella vermicola,53793,27,25,2,54
Cymbomonas tetramitiformis,73520,31,31,3,65
Pectinodesmus pectinatus,32195,13,27,6,46
Clonostachys rosea,40921,15,25,2,42
Endarachne binghamiae,37460,40,23,3,66
Kazachstania sinensis,38566,13,23,2,38
Helianthus annuus,300945,26,15,3,44
Macaca radiata,16563,13,22,2,37
Caryanda elegans,15459,13,22,2,37
Melanocorypha mongolica,17358,13,22,2,37
Xenoturbella japonica,15249,13,22,2,37
Neoris haraldi,15383,13,22,2,37
Lutraria maxima,17082,13,22,2,37
Iriatherina werneri,16526,13,22,2,37
Atherinomorus lacunosus,16552,13,22,2,37
Saccostrea echinata,16281,12,23,3,38
Saccostrea mytiloides,16282,12,23,3,38
Trocnadella arisana,15131,13,22,2,37
Episyrphus balteatus,16175,13,22,2,37
Eupeodes corollae,15326,13,22,2,37
Saccostrea glomerata,16282,12,23,3,38
Triuncina daii,15482,13,22,2,37
Modiolus kurilensis,16210,12,22,2,36
Anodonta cygnea,15613,13,22,2,37
Phrynosoma blainvillii,16946,13,22,2,37
Bokermannohyla alvarengai,17325,13,22,2,37
Carabus lafossei,16793,13,22,2,37
Trugon terrestris,17405,13,22,2,37
Otidiphaps nobilis,17346,13,22,2,37
Goura victoria,17743,13,22,2,37
Tachysurus fulvidraco x Leiocassis longirostris,16526,13,22,2,37
Ascaris ovis,14288,12,22,2,36
Ortleppascaris sinensis,13828,12,22,2,36
Notonecta chinensis,15149,13,22,2,37
Thryssa hamiltonii,16737,13,22,2,37
Arius arius,16711,13,22,2,37
Glossogobius giuris,16596,13,22,2,37
Acipenser gueldenstaedtii x Acipenser baerii,16594,13,22,2,37
Centropyge deborae,16843,13,22,2,37
Stegobium paniceum,15271,13,22,2,37
Ectropis obliqua,16535,13,22,2,37
Parexocoetus brachypterus,16776,13,22,2,37
Cheilopogon agoo,16526,13,22,2,37
Cheilopogon cyanopterus,16529,13,22,2,37
Prognichthys sealei,16527,13,22,2,37
Bunomys penitus,16308,13,22,2,37
Halmaheramys bokimekot,16291,13,22,2,37
Paruromys dominator,16297,13,22,2,37
Sundamys maxi,16303,13,22,2,37
Sundamys infraluteus,16298,13,22,2,37
Sundamys annandalei,16299,13,22,2,37
Berylmys berdmorei,16292,13,22,2,37
Lenothrix canus,16285,13,22,2,37
Maxomys surifer,16291,13,22,2,37
Gynaephora ruoergensis,15803,13,22,2,37
Gynaephora jiuzhiensis,15859,13,22,2,37
Gynaephora minora,15801,13,22,2,37
Hemiculter tchangi,16621,13,22,2,37
Sinogastromyzon szechuanensis,16565,13,22,2,37
Gonopsis affinis,16011,13,22,2,37
Schizothorax integrilabiatus,16588,13,22,2,37
Atrocalopteryx melli,15562,13,22,2,37
Fabriciana nerippe,15140,13,22,2,37
Lingula anatina,25790,13,34,2,49
Chrysochromulina parva,24009,20,25,2,47
Mielichhoferia elongata,100342,39,24,3,66
Pleurotus citrinopileatus,60694,25,24,2,51
Pleurotus platypus,73807,34,24,3,61
Trilophozia quinquedentata,142510,42,28,3,73
Siren lacertina,16545,13,22,2,37
Haliotis rufescens,16646,13,22,2,37
Gadus macrocephalus,16569,13,22,2,37
Schizothorax eurystomus,16588,13,22,2,37
Longpotamon yangtsekiense,17885,13,22,2,37
Sinopotamon yaanense,17126,13,22,2,37
Channa gachua,16547,13,22,2,37
Centropyge vrolikii,16966,13,22,2,37
Hydropsyche simulans,15268,13,22,2,37
Hydropsyche orris,15213,13,22,2,37
Cheumatopsyche speciosa,15098,13,22,2,37
Potamyia flava,15157,13,22,2,37
Dryophytes japonicus,19519,13,22,2,37
Conus quercinus,16430,13,22,2,37
Mus pahari,16286,13,22,2,37
Trichoderma asperellum,29999,17,25,1,43
Dipylidium caninum,14296,12,22,2,36
Cheumatopsyche campyla,15098,13,22,2,37
Cheumatopsyche analis,15098,13,22,2,37
Vipera berus,16370,13,22,2,37
Eochionelasmus ohtai,15585,13,22,2,37
Auriculastra duplicata,13920,13,22,2,37
Lophius piscatorius,16471,13,22,2,37
Biomphalaria straminea,13650,13,22,2,37
Longchuanacris curvifurculus,15450,13,22,2,37
Mastomys natalensis,16215,13,22,2,37
Mesoplodon stejnegeri,16349,13,22,2,37
Argynnis sagana,15151,13,22,2,37
Notropis chalybaeus,16716,13,22,2,37
Notropis heterolepis,16709,13,22,2,37
Rhinichthys obtusus,16650,13,22,2,37
Cyprinella leedsi,16702,13,22,2,37
Ameiurus catus,16510,13,22,2,37
Catostomus catostomus,16622,13,22,2,37
Notropis hudsonius,16715,13,22,2,37
Exoglossum maxillingua,16648,13,22,2,37
Alosa mediocris,16643,13,22,2,37
Alosa aestivalis,16646,13,22,2,37
Coptotermes suzhouensis,15764,13,22,2,37
Oreochromis andersonii,16642,13,22,2,37
Oreochromis macrochir,16644,13,22,2,37
Eurydema maracandica,15391,13,22,2,37
Sergia lucens,16087,13,22,2,37
Solegnathus hardwickii,16519,13,22,2,37
Syngnathoides biaculeatus,16479,13,22,2,37
Doryichthys boaja,16547,13,22,2,37
Trachyrhamphus serratus,16956,13,22,2,37
Pseudobagrus medianalis,16647,13,22,2,37
Alepes djedaba,16563,13,22,2,37
Alectis indica,16553,13,22,2,37
Arabis alpina,323159,33,18,3,54
Hydatigera kamiyai,13853,12,22,2,36
Styela clava,14616,13,24,2,39
Periophthalmus minutus,16506,13,22,2,37
Pentatomidae sp. GM-2014,15498,13,22,2,37
Maccullochella mariensis,16437,13,22,2,37
Paraescarpia echinospica,15280,13,22,2,37
Sahyadria denisonii,16899,13,22,2,37
Lateolabrax maculatus,16723,13,22,2,37
Agramma hupehanum,15992,13,22,2,37
Phatnoma laciniatum,15821,13,22,2,37
Varuna yui,15915,13,22,2,37
Pseudocercospora mori,49363,31,25,2,58
Alectoria fallacina,75417,13,29,2,44
Sibylla pretiosa,15829,13,22,2,37
Trametes hirsuta,59039,24,26,2,52
Salarias fasciatus,16496,13,22,2,37
Pogona vitticeps,16751,13,22,2,37
Trichoplax adhaerens,43079,17,22,3,42
Moxostoma poecilurum,16637,13,22,2,37
Marilyna darwinii,16406,13,22,2,37
Leiodon cutcutia,16624,13,22,2,37
Tuberoschistura baenzigeri,16570,13,22,2,37
Ellopostoma mystax,17300,13,22,2,37
Pseudoterranova bulbosa,13957,12,22,2,36
Pseudoterranova cattani,13950,12,22,2,36
Pseudoterranova decipiens sensu lato Germany,13962,12,22,2,36
Pseudoterranova krabbei,13948,12,22,2,36
Contracaecum ogmorhini sensu lato Australia,14019,12,22,2,36
Contracaecum ogmorhini sensu lato South Africa,14012,12,22,2,36
Contracaecum ogmorhini sensu lato Pacific Canada,14010,12,22,2,36
Ducetia japonica,16276,13,22,2,37
Chlorostoma argyrostomum,17780,13,21,2,36
Omphalius nigerrimus,17755,13,22,2,37
Echinoderes svetlanae,15304,13,23,2,38
Pseudocosmetura anjiensis,16044,13,22,2,37
Nippostrongylus brasiliensis,13355,12,21,2,35
Pseudokuzicus pieli,16077,13,22,2,37
Pseudorhynchus crassiceps,15865,13,22,2,37
Pseudorhynchus acuminatus,16056,13,22,2,37
Holochlora fruhstorferi,15899,13,22,2,37
Phryganogryllacris xiai,15876,13,22,2,37
Kuwayamaea chinensis,15875,13,22,2,37
Corvus cryptoleucus,16928,13,22,2,37
Nemoura nankinensis,16602,13,22,2,37
Oscarella pearsei,20320,15,26,2,43
Donax semiestriatus,17044,13,22,2,37
Donax trunculus,17365,13,22,2,37
Donax variegatus,17195,13,22,2,37
Donax vittatus,17070,13,22,2,37
Anabolia bimaculata,15048,13,22,2,37
Culex usquatus,15573,13,22,2,37
Culex coronator,15576,13,22,2,37
Culex usquatissimus,15574,13,22,2,37
Culex camposi,15570,13,22,2,37
Dendronephthya putteri,18853,14,1,2,17
Vincenzellus ruficollis,15754,13,22,2,37
Dryops ernesti,15672,13,22,2,37
Pelecotoma fennica,15946,13,22,2,37
Xylosandrus morigerus,16246,13,22,2,37
Calophya californica,15273,13,22,2,37
Myotis ruber,16984,13,22,2,37
Sterna hirundo,16707,13,22,2,37
Microceramus pontificus,14275,13,22,2,37
Lonchura grandis,16830,13,22,2,37
Chromodoris annae,14260,13,22,2,37
Sardinella gibbosa,16658,13,22,2,37
Artyfechinostomum sufrartyfex,14567,12,22,2,36
Candidia barbata,16608,13,22,2,37
Atergatis integerrimus,15924,13,22,2,37
Peromyscus leucopus,16326,13,22,2,37
Penion sulcatus,15227,13,22,2,37
Ochotona erythrotis,16663,13,22,2,37
Armillifer grandis,16073,13,22,2,37
Altiverruca navicula,15976,13,22,2,37
Haemaphysalis japonica,14685,13,22,2,37
Stomias atriventer,17596,13,22,2,37
Triphoturus mexicanus,18012,13,22,2,37
Philaenus spumarius,16324,13,22,2,37
Pteronarcys princeps,16004,13,22,2,37
Chrotopterus auritus,16707,13,22,2,37
Diaemus youngi,16628,13,22,2,37
Hsunycteris thomasi,16661,13,22,2,37
Lonchorhina aurita,16661,13,22,2,37
Macrotus californicus,16691,13,22,2,37
Noctilio leporinus,16659,13,22,2,37
Glyphonycteris daviesi,16655,13,22,2,37
Eleotris fusca,16521,13,22,2,37
Bathygobius coalitus,16681,13,22,2,37
Brachygobius doriae,16472,13,22,2,37
Exyrias puntang,16500,13,22,2,37
Rhinogobius rubromaculatus,16503,13,22,2,37
Bombyx lemeepauli,15801,13,22,2,37
Sicalis olivascens,16768,13,22,2,37
Lepidocolaptes angustirostris,16973,13,22,2,37
Monomia gladiator,15878,13,22,2,37
Sorex sinalis,17216,13,22,2,37
Euzophera pyriella,15184,13,22,2,37
Anemonia viridis,20108,15,2,2,19
Anemonia manjano,19545,15,2,2,19
Changeondelphax velitchkovskyi,16449,13,22,2,37
Peregrinus maidis,16279,13,22,2,37
Schizothorax molesworthi,16585,13,22,2,37
Charonia lampas,15405,13,22,2,37
Phylloscopus proregulus,16880,13,22,2,37
Clarias dussumieri,16514,13,22,2,37
Hydrotaea ignava,17026,13,22,2,37
Tenebrio obscurus,15771,13,22,2,37
Sinocyclocheilus jii,16577,13,22,2,37
Dermestes maculatus,16390,13,22,2,37
Atergatis floridus,16180,13,22,2,37
Amantis nawai,15684,13,22,2,37
Sphodromantis lineola,15475,13,22,2,37
Tropidomantis tenera,15609,13,22,2,37
Sceptuchus simplex,15548,13,22,2,37
Schizocephala bicornis,16026,13,25,2,40
Eomantis yunnanensis,15466,13,22,2,37
Empoasca onukii,15167,13,22,2,37
Rhadinosa nigrocyanea,17965,13,22,2,37
Mobula thurstoni,17610,13,22,2,37
Mene maculata,16733,13,22,2,37
Indothais lacera,15272,13,22,2,37
Centruroides vittatus,14602,13,21,2,36
Mycopsylla fici,14815,13,22,2,37
Mycopsylla proxima,14864,13,22,2,37
Creobroter jiangxiensis,15801,13,25,2,40
Marphysa tamurai,15163,13,22,2,37
Tesseropora rosea,15330,13,22,2,37
Lateolabrax maculatus,16601,13,22,2,37
Tor douronensis,16586,13,22,2,37
Tor tambra,16581,13,22,2,37
Fimbriaphyllia ancora,18875,13,2,2,17
Ricordea florida,21376,13,2,2,17
Papilio helenus,15349,13,22,2,37
Teleaulax amphioxeia,43442,46,26,2,74
Prototheca ciferrii,38164,33,26,3,62
Chroomonas placoidea,46700,49,27,2,78
Storeatula sp. CCMP1868,61567,47,26,2,75
Proteomonas sulcata,48236,42,25,2,69
Cryptomonas curvata,39464,42,25,2,69
Citrus sinensis,640906,33,35,3,71
Nymphaea colorata,617195,42,20,3,65
Anthoceros angustus,242410,49,20,3,72
Marchantia polymorpha subsp. ruderalis,186196,65,29,3,97
Plasmodium falciparum,5967,3,0,0,3
Wickerhamiella sorbophila,23627,0,0,0,0
Montipora aequituberculata,17886,13,2,2,17
Microdevario kubotai,16775,13,22,2,37
Melophagus ovinus,15573,13,22,2,37
Scaphiopus holbrookii,16881,13,22,2,37
Hyloxalus subpunctatus,16751,13,22,2,37
Phyllobates terribilis,17702,13,22,2,37
Oreolalax multipunctatus,17358,13,23,2,38
Chelodina expansa,16503,13,22,2,37
Chelodina mccordi,16508,13,22,2,37
Chelodina parkeri,16523,13,22,2,37
Chelodina pritchardi,16503,13,22,2,37
Chelodina oblonga,16568,13,22,2,37
Halichondria okadai,20722,14,25,2,41
Choristoneura occidentalis,15536,13,22,2,37
Choristoneura biennis,15533,13,22,2,37
Choristoneura fumiferana,15304,13,22,2,37
Choristoneura murinana,15540,13,22,2,37
Choristoneura rosaceana,15544,13,22,2,37
Tetraclita rufotincta,15002,13,22,2,37
Acheilognathus omeiensis,16774,13,22,2,37
Semilabeo obscurus,16598,13,23,2,38
Alasmidonta heterodon,15909,14,22,2,38
Porites harrisoni,18630,13,2,2,17
Macaca sinica,16525,13,22,2,37
Macroglossum stellatarum,15290,13,22,2,37
Eubalaena glacialis,16386,13,22,2,37
Psilogramma increta,15252,13,22,2,37
Garrulax albogularis,17870,13,22,2,37
Bagre panamensis,16718,13,22,2,37
Urocissa caerulea,16928,13,22,2,37
Diaphanosoma dubium,16362,13,22,2,37
Haemaphysalis longicornis,14718,13,22,2,37
Cryptocercus meridianus,15322,13,22,2,37
Sabethes belisarioi,15911,13,22,2,37
Sabethes chloropterus,15609,13,22,2,37
Salvelinus malma,16652,13,22,2,37
Pagellus acarne,16486,13,22,2,37
Psammomys obesus,16592,13,22,2,37
Incisitermes minor,15970,13,22,2,37
Streptopelia decaocto,17160,13,22,2,37
Syngnathus schlegeli,16462,13,22,2,37
Ornithodoros savignyi,14401,13,22,2,37
Bradypus tridactylus,16920,13,22,2,37
Moniezia expansa,13934,12,22,2,36
Drosophila melanogaster,19524,13,22,2,37
Theileria equi strain WA,9001,3,0,0,3
Nassarius fraterculus,15174,13,21,2,36
Anarhichas denticulatus,16514,13,22,2,37
Nassarius festivus,15195,13,22,2,37
Gasteruption parvicollarium,17009,13,24,2,39
Anarhichas minor,16512,13,22,2,37
Cryptopygus terranovus,15352,13,22,2,37
Camallanus cotti,17901,13,25,2,40
Saccharomycodes ludwigii,66725,12,24,2,38
Halamphora coffeaeformis,44653,39,22,2,63
Melosira undulata,32777,32,24,2,58
Nitzschia alba,36252,36,24,2,62
Pichia kudriavzevii,51126,0,0,0,0
Cantharellus appalachiensis,73562,41,25,2,68
Cantharellus lutescens,80736,49,26,2,77
Russula compacta,69423,38,27,2,67
Russula abietina,67683,45,27,2,74
Russula foetens,58585,35,25,2,62
Russula lepida,56008,32,25,2,59
Russula virescens,48512,29,24,2,55
Grateloupia filicina,29274,26,24,2,52
Gracilaria edulis,25708,25,23,2,50
Gracilaria spinulosa,25734,25,23,2,50
Agarophyton tenuistipitatum,25819,25,23,2,50
Gracilaria textorii,25743,25,22,2,49
Ganoderma tsugae,92511,57,25,2,84
Ganoderma leucocontextum,88194,57,25,2,84
Ganoderma calidophilum,124588,76,25,2,103
Cylindrotheca closterium,37784,39,24,2,65
Eunotia naegelii,48049,41,23,2,66
Toxarium undulatum,40429,40,26,2,68
Psammoneis japonica,73622,46,27,2,75
Nitzschia sp. (in: Bacillariophyta),36012,38,24,2,64
Tamias quadrivittatus,16549,13,22,2,37
Tamias rufus,16543,13,22,2,37
Tamias canipes,16552,13,22,2,37
Tamias dorsalis,16549,13,22,2,37
Tamias cinereicollis,16549,13,22,2,37
Tamias striatus,16553,13,22,2,37
Tamias umbrinus,16552,13,22,2,37
Fusarium venenatum,78612,0,0,0,0
Pomacea bridgesi,16640,13,22,2,37
Emberiza leucocephalos,16754,13,22,2,37
Charybdis bimaculata,15714,13,22,2,37
Paratoxodera polyacantha,15999,13,26,2,41
Callipogon relictus,15742,13,22,2,37
Pygoscelis papua,16712,13,22,2,37
Triplophysa sp. ZP-2016,16569,13,22,2,37
Cheilinus fasciatus,16872,13,22,2,37
Halichoeres hartzfeldii,16481,13,22,2,37
Apis dorsata,15892,13,22,2,37
Junonia rhadama,15208,13,22,2,37
Prochilodus vimboides,16696,13,22,2,37
Leucoraja circularis,16719,13,22,2,37
Raja asterias,16920,13,22,2,37
Raja polystigma,16918,13,22,2,37
Raja clavata,16920,13,22,2,37
Raja miraletus,16920,13,22,2,37
Amblyraja georgiana,16734,13,22,2,37
Bathyraja maccaini,16744,13,22,2,37
Bathyraja meridionalis,16742,13,22,2,37
Bathyraja richardsoni,16742,13,22,2,37
Bathyraja shuntovi,16744,13,22,2,37
Moschiola indica,16444,13,23,2,38
Prismostictoides unihyala,15355,13,22,2,37
Fusarium gerlachii,93428,53,28,2,83
Calyptogena magnifica,19738,13,21,2,36
Zasmidium cellare,23743,15,25,2,42
Spirobranchus giganteus,22058,12,24,2,38
Paramesotriton deloustali,16391,13,22,2,37
Prochilodus harttii,16697,13,22,2,37
Lampsilis powellii,16043,14,22,2,38
Bactrocera limbifera,15860,13,22,2,37
Bactrocera ritsemai,15927,13,22,2,37
Dinorhynchus dybowskyi,15952,13,22,2,37
Theretra japonica,15399,13,22,2,37
Dentex gibbosus,16771,13,22,2,37
Pagellus erythrinus,16828,13,22,2,37
Amblythyreus gestroi,15228,13,22,2,37
Carcinochelis bannaensis,15335,13,22,2,37
Acanthaspis cincticrus,15686,13,22,2,37
Inara alboguttata,15436,13,22,2,37
Tapeinus singularis,15312,13,22,2,37
Velinus nodipes,15904,13,22,2,37
Cyclopelta parva,15422,13,22,2,37
Saldula burmanica,15682,13,22,2,37
Carbula sinica,15233,13,22,2,37
Tessaratoma papillosa,15565,13,22,2,37
Rhynocoris incertis,15707,13,22,2,37
Scipinia horrida,15660,13,22,2,37
Canthesancus helluo,15743,13,22,2,37
Reduvius gregoryi,16477,13,22,2,37
Urostylis flavoannulata,15638,13,22,2,37
Limbodessus palmulaoides,16868,13,22,2,37
Paroster macrosturtensis,16676,13,22,2,37
Paroster mesosturtensis,16663,13,22,2,37
Paroster microsturtensis,16504,13,22,2,37
Suwallia teleckojensis,16146,13,22,2,37
Dentex dentex,16656,13,22,2,37
Semisulcospira coreana,15398,12,22,2,36
Echimys saturnus,16600,13,22,2,37
Makalata macrura,16631,13,22,2,37
Pattonomys punctatus,16549,13,22,2,37
Pattonomys semivillosus,16553,13,22,2,37
Toromys albiventris,16656,13,22,2,37
Toromys rhipidurus,16683,13,22,2,37
Lytechinus variegatus,15693,13,22,2,37
Anopheles rangeli,15386,13,22,2,37
Anopheles benarrochi,15387,13,22,2,37
Anopheles marajoara,15453,13,22,2,37
Anopheles peryassui,15417,13,22,2,37
Anopheles braziliensis,15397,13,22,2,37
Anopheles atacamensis,15412,13,22,2,37
Anopheles oswaldoi,15380,13,22,2,37
Anopheles costai,15433,13,22,2,37
Anopheles evansae,15382,13,22,2,37
Bironella hollandi,15772,13,22,2,37
Culex surinamensis,15568,13,22,2,37
Anopheles sawyeri,15417,13,22,2,37
Anopheles lanei,15396,13,22,2,37
Anopheles triannulatus,15401,13,22,2,37
Anopheles striatus,15385,13,22,2,37
Anopheles minor,15466,13,22,2,37
Anopheles gilesi,15458,13,22,2,37
Anopheles albertoi,15385,13,22,2,37
Anopheles parvus,15444,13,22,2,37
Anopheles arthuri,15387,13,22,2,37
Anopheles argyritarsis,15403,13,22,2,37
Anopheles strodei,15388,13,22,2,37
Culex bidens,15583,13,22,2,37
Anopheles goeldii,15391,13,22,2,37
Anopheles nimbus,15471,13,22,2,37
Culex mollis,15580,13,22,2,37
Anopheles forattinii,15459,13,22,2,37
Anopheles galvaoi,15420,13,22,2,37
Anopheles rondoni,15385,13,22,2,37
Anopheles guarani,15531,13,22,2,37
Anopheles antunesi,15427,13,22,2,37
Anopheles fluminensis,15429,13,22,2,37
Culex bilineatus,15599,13,22,2,37
Anopheles lutzii,15341,13,22,2,37
Anopheles nr. costai SP02_17_3,15434,13,22,2,37
Culex declarator,15575,13,22,2,37
Culex nigripalpus,15571,13,22,2,37
Anopheles pristinus,15405,13,22,2,37
Culex lygrus,15572,13,22,2,37
Culex chidesteri,16052,13,22,2,37
Anopheles kompi,15505,13,22,2,37
Culex brami,15586,13,22,2,37
Anopheles pseudotibiamaculatus,15597,13,22,2,37
Cysteochila chiniana,15475,13,22,2,37
Dictyla platyoma,15649,13,22,2,37
Metasalis populi,15257,13,22,2,37
Tingis cardui,14711,13,22,2,37
Trachypeplus jacobsoni,15712,13,22,2,37
Dendrothrips minowai,14631,13,22,2,37
Gerres filamentosus,16795,13,22,2,37
Liza carinata,16835,13,22,2,37
Lagenodelphis hosei,16390,13,22,2,37
Gorilla beringei,15448,13,22,2,37
Anomaloglossus surinamensis,17148,13,22,2,37
Anomaloglossus dewynteri,17256,13,22,2,37
Anomaloglossus degranvillei,17090,13,22,2,37
Anomaloglossus blanci,16284,13,22,2,37
Sinocyclocheilus oxycephalus,16585,13,22,2,37
Sorex gracillimus,17002,13,22,2,37
Euryades corethrus,15133,13,22,2,37
Bhutanitis mansfieldi,14994,13,22,2,37
Lamproptera meges,15113,13,22,2,37
Losaria neptunus,14901,13,22,2,37
Ornithoptera richmondia,14763,13,22,2,37
Ornithoptera priamus,14804,13,22,2,37
Mimoides lysithous,15038,13,22,2,37
Papilio slateri,14821,13,22,2,37
Trogonoptera brookiana,15005,13,21,2,36
Falcidens acutargatus,14209,13,22,2,37
Falcidens halanychi,14508,13,22,2,37
Leontopithecus chrysopygus,16618,13,22,2,37
Phractocephalus hemioliopterus,16491,13,22,2,37
Reticunassa hiradoensis,15194,13,22,2,37
Cricetus cricetus,16263,13,22,2,37
Ara tricolor,16985,13,22,2,37
Taeniopteryx ugola,15353,13,22,2,37
Pidorus atratus,15383,13,22,2,37
Musca sorbens,16120,13,22,2,37
Cardiodactylus muiri,16328,13,22,2,37
Triplophysa cuneicephala,16571,13,22,2,37
Triplophysa dalaica,16569,13,22,2,37
Lygus pratensis,16591,13,22,2,37
Dorysthenes paradoxus,15922,13,22,2,37
Salmo obtusirostris,16676,13,22,2,37
Mylodon darwinii,16443,13,22,2,37
Gibbosula crassa,16196,14,22,2,38
Echinaster brasiliensis,16219,13,22,2,37
Lyonetia clerkella,15259,13,22,2,37
Cryptonome barbada,15013,13,23,2,38
Dipturus nasutus,16909,13,22,2,37
Dipturus innominatus,16913,13,22,2,37
Bathyraja multispinis,16742,13,22,2,37
Bathyraja albomaculata,16742,13,22,2,37
Bathyraja griseocauda,16744,13,22,2,37
Dipturus maugeanus,16908,13,22,2,37
Dipturus oxyrinchus,16912,13,22,2,37
Leucoraja naevus,16719,13,22,2,37
Dermatophagoides farinae,14266,13,22,2,37
Hemiphaga novaeseelandiae,17264,13,22,2,37
Serrivomer sector,16099,13,22,2,37
Mylocheilus caurinus,16657,13,22,2,37
Chaetoderma nitidulum,21008,14,22,2,38
Bufoceratias thele,16430,13,22,2,37
Astrospartus mediterraneus,16238,13,22,2,37
Serinus canaria,16805,13,22,2,37
Argas walkerae,14437,13,22,2,37
Salmo ischchan,16677,13,22,2,37
Gammarus roeselii,16073,13,22,2,37
Porites fontanesii,18658,13,2,2,17
Porzana paykullii,16955,13,22,2,37
Occidentarius platypogon,16714,13,22,2,37
Aglaomorpha histrio,15472,13,22,2,37
Acanthaspis ruficeps,15846,13,22,2,37
Argas striatus,14487,13,22,2,37
Carios faini,14433,13,22,2,37
Neolethaeus assamensis,15067,13,22,2,37
Shinkaicaris leurokolos,15903,13,22,2,37
Nabicula flavomarginata,16366,13,22,2,37
Melanophryniscus moreirae,18005,13,22,2,37
Gyge ovalis,14268,13,19,2,34
Macaca mulatta vestita,16565,13,22,2,37
Aphelocheirus jendeki,15168,13,22,2,37
Metatropis longirostris,15744,13,22,2,37
Macrosaldula sp. PJ-2017,15303,13,22,2,37
Dalsira scabrata,15614,13,22,2,37
Notopteryx soror,15862,13,22,2,37
Toxodera hauseri,15616,13,22,2,37
Amarsipus carlsbergi,16510,13,22,2,37
Cirriformia cf. tentaculata HK-2018,15495,13,23,2,38
Microphysogobio kiatingensis,16603,13,22,2,37
Sarcocheilichthys davidi,16675,13,22,2,37
Ancherythroculter wangi,16622,13,22,2,37
Sabethes glaucodaemon,15620,13,22,2,37
Endotricha consocia,15201,13,22,2,37
Schizothorax taliensis,16578,13,22,2,37
Paraona staudingeri,15427,13,22,2,37
Geophagus brasiliensis,16559,13,22,2,37
Thorichthys aureus,16530,13,22,2,37
Nannacara anomala,16502,13,22,2,37
Bombax ceiba,594390,34,25,3,62
Senna tora,566589,36,22,5,63
Lactarius volemus,38445,22,25,2,49
Lactarius deliciosus,53895,33,24,2,59
Lactarius piperatus,60843,33,26,2,61
Pleurotus cornucopiae,72134,15,24,2,41
Gracilariopsis heteroclada,25817,25,22,2,49
Porolithon onkodes,27882,23,21,2,46
Sargassum yezoense,34767,37,25,3,65
Rhizoglyphus robini,14244,13,22,2,37
Biomphalaria pfeifferi,13624,13,21,2,36
Biomphalaria sudanica,13671,13,22,2,37
Biomphalaria choanomphala,13672,13,22,2,37
Dosinia japonica,17693,13,22,2,37
Tragelaphus buxtoni,16601,13,22,2,37
Parasesarma pictum,15611,13,22,2,37
Caridina multidentata,15825,13,22,2,37
Alpheus hoplocheles,15735,13,22,2,37
Parapenaeopsis hungerfordi,15952,13,22,2,37
Cyathostomum pateratum,13822,12,22,2,36
Scutopus robustus,14515,13,22,2,37
Andraca olivacea,15880,13,22,2,37
Comparmustilia sphingiformis,15100,13,22,2,37
Ganisa cyanogrisea,15250,13,22,2,37
Mustilia undulosa,15720,13,22,2,37
Oberthueria jiatongae,15673,13,22,2,37
Ocinara albicollis,15439,13,22,2,37
Aegosoma sinicum,15658,13,22,2,37
Anastrangalia sequensi,16269,13,22,2,37
Ernolatia moorei,15377,13,22,2,37
Mustilizans hepatica,15745,13,22,2,37
Prismosticta fenestrata,15772,13,22,2,37
Allocarsidara bakeri,15688,13,22,2,37
Anoeconeossa unicornuta,15051,13,22,2,37
Diclidophlebia paucipunctata,15232,13,22,2,37
Homotoma ficus,14983,13,22,2,37
Lanthanaphalara mira,15349,13,22,2,37
Paracarsidara gigantea,15633,13,22,2,37
Trioza urticae,15185,13,22,2,37
Apis nigrocincta,15855,13,22,2,37
Popillia japonica,16541,13,22,2,37
Alpheus japonicus,16619,13,22,2,37
Palaemon annandalei,15718,13,22,2,37
Microhyla mixtura,16729,13,22,2,37
Aacanthocnema dobsoni,15179,13,22,2,37
Arytainilla spartiophila,14790,13,22,2,37
Euphyllura phillyreae,15202,13,22,2,37
Freysuila caesalpiniae,15327,13,22,2,37
Leptynoptera sulfurea,14825,13,22,2,37
Livia junci,15172,13,22,2,37
Pariaconus pele,15080,13,22,2,37
Psylla alni,14971,13,22,2,37
Russelliana solanicola,16047,13,22,2,37
Trioza anthrisci,14918,13,22,2,37
Trioza erytreae,16788,13,22,2,37
Trioza remota,14950,13,22,2,37
Acizzia uncatoides,14957,13,22,2,37
Blastopsylla occidentalis,14751,13,22,2,37
Cacopsylla pyri,14886,13,22,2,37
Heteropsylla cubana,15284,13,22,2,37
Misgurnus mizolepis,16571,13,22,2,37
Anthracoceros coronatus,17216,13,22,2,37
Neptis alwina,15226,13,22,2,37
Alasmidonta varicosa,15693,14,22,2,38
Vanessa indica,15191,13,22,2,37
Anopheles funestus,15356,13,22,2,37
Lactarius hatsudake,46808,24,26,2,52
Gracilaria chouae,25829,25,23,2,50
Lyophyllum shimeji,73678,30,26,2,58
Lactifluus hygrophoroides,48541,27,24,2,53
Caulerpa lentillifera,209034,59,20,3,82
Senna occidentalis,447106,34,21,3,58
Lyophyllum decastes,50643,18,26,2,46
Cyclospora cayetanensis,6274,3,0,23,26
Zea mays subsp. mays,569630,163,29,4,196
Huananpotamon lichuanense,15380,13,22,2,37
Tolypocladium inflatum,25328,15,25,2,42
Neoceratias spinifer,16417,13,22,2,37
Cladonia peziziformis,45312,17,25,2,44
Crassa caudata,26030,25,24,2,51
Gracilaria ferox,25588,25,23,2,50
Gracilaria gracilis,25865,25,24,3,52
Hydropuntia rangiferina,25908,25,24,3,52
Gracilariopsis longissima,26744,26,24,3,53
Gracilariopsis mclachlanii,26012,25,24,3,52
Melanthalia intermedia,25348,25,20,3,48
Pseudevernia consocians,76322,14,25,2,41
Uronema marinum,39845,39,6,2,47
Parahyaena brunnea,17197,13,22,2,37
Culex gelidus,15600,13,22,2,37
Idiurus macrotis,16927,13,22,2,37
Zenkerella insignis,16684,13,22,2,37
Bactrocera tsuneonis,15865,13,22,2,37
Spongiocaris panglao,15909,13,22,2,37
Isoperla eximia,16034,13,22,2,37
Pseudomegarcys japonica,16067,13,22,2,37
Nassarius hepaticus,15337,13,22,2,37
Anomalurus beecrofti,16820,13,22,2,37
Anomalurus pelii,16871,13,22,2,37
Anomalurus derbianus,16876,13,22,2,37
Anomalurus pusillus,16773,13,22,2,37
Gymnothorax minor,16574,13,22,2,37
Microtus arvalis,16285,13,22,2,37
Gelasimus borealis,15659,13,22,2,37
Metopograpsus quadridentatus,15517,13,22,2,37
Gaetice depressus,16288,13,22,2,37
Dotilla wichmanni,15600,13,22,2,37
Bathytoma punicea,16037,13,22,2,37
Gemmuloborsonia moosai,15541,13,22,2,37
Splendrillia sp. 1 MNHN IM 2013-9619,15358,13,22,2,37
Leucosyrinx sp. MNHN IM 2013-19304,15358,13,22,2,37
Typhlosyrinx sp. MNHN IM 2013-18371,15804,13,22,2,37
Soliperla sp. ZTC-2018,15877,13,22,2,37
Isoperla bilineata,15048,13,22,2,37
Cicindela anchoralis,16388,13,22,2,37
Pectinatella magnifica,17539,13,22,2,37
Milvus migrans,18016,13,22,2,37
Thryssa setirostris,16926,13,22,2,37
Lasioderma serricorne,14476,13,22,2,37
Buceros bicornis,17117,13,22,2,37
Histiostoma feroniarum,13896,13,22,2,37
Eterusia aedea,15196,13,22,2,37
Graphomya rufitibia,15374,13,22,2,37
Macrodorcas seguyi,17955,13,22,2,37
Octopus variabilis,15992,13,22,2,37
Gyrodactylus nyanzae,14885,12,22,2,36
Strix uralensis,18708,13,22,2,37
Bubo bubo,18952,13,23,2,38
Bubo scandiacus,18734,13,23,2,38
Luciola curtithorax,16882,13,22,2,37
Periophthalmus novemradiatus,16488,13,22,2,37
Echinococcus granulosus sensu lato genotype G6,13553,12,22,2,36
Echinococcus granulosus sensu lato genotype G7,13552,12,22,2,36
Sus scrofa cristatus,16738,13,22,2,37
Capreolus pygargus tianschanicus,16357,13,22,2,37
Nanorana ventripunctata,18373,13,23,2,38
Tringa glareola,16804,13,22,2,37
Sinotaia purificata,17310,13,22,2,37
Proechimys guyannensis,16823,13,22,2,37
Proechimys cuvieri,16776,13,22,2,37
Proechimys brevicauda,16548,13,22,2,37
Proechimys gularis,16529,13,22,2,37
Proechimys semispinosus,16826,13,22,2,37
Rhizomys sumatrensis,16672,13,22,2,37
Cardisoma carnifex,15597,13,22,2,37
Tubuca polita,15672,13,22,2,37
Tubuca capricornis,15629,13,22,2,37
Pilumnus vespertilio,16222,13,22,2,37
Pachygrapsus marmoratus,15406,13,22,2,37
Epixanthus frontalis,15993,13,22,2,37
Cranuca inversa,15677,13,22,2,37
Munida isos,17910,13,23,2,38
Metynnis hypsauchen,16737,13,22,2,37
Myleus cf. schomburgkii XL-2018,16666,13,22,2,37
Myloplus rubripinnis,16662,13,22,2,37
Penion chathamensis,15227,13,22,2,37
Antarctoneptunea aurora,15227,13,22,2,37
Penion cuvierianus,15235,13,22,2,37
Antarctoneptunea benthicola,15229,13,22,2,37
Aeneator elegans,15254,13,22,2,37
Buccinulum fuscozonatum,15246,13,22,2,37
Aeneator recens,15264,13,22,2,37
Kelletia lischkei,15225,13,22,2,37
Buccinulum pertinax finlayi,15247,13,22,2,37
Cominella adspersa,15251,13,22,2,37
Penion ormesi,15234,13,22,2,37
Oreonectes daqikongensis,16578,13,22,2,37
Vespa affinis,19109,13,22,2,37
Polyacanthonotus rissoanus,16622,13,22,2,37
Aldrovandia oleosa,16653,13,22,2,37
Neocyema erythrosoma,17765,13,22,2,37
Gymnothorax niphostigmus,16576,13,22,2,37
Aristaeomorpha foliacea,15926,13,22,2,37
Aristeus virilis,15936,13,22,2,37
Phymatostetha huangshanensis (nomen nudum),17785,13,22,2,37
Chaenodraco wilsoni,17432,13,22,2,37
Chicoreus torrefactus,15359,13,22,2,37
Reishia luteostoma,15301,13,22,2,37
Parum colligata,15288,13,22,2,37
Sicyonia japonica,15918,13,22,2,37
Sicyonia lancifer,15926,13,22,2,37
Hymenopenaeus neptunus,15905,13,22,2,37
Gennadas parvus,15917,13,22,2,37
Benthonectes filipes,17361,13,28,2,43
Gordonella aff. paravillosa ZS-2018,15916,13,22,2,37
Meles leucurus,16529,13,22,2,37
Vargula tsujii,15729,13,22,2,37
Microhyla taraiensis,16764,13,22,2,37
Omiodes indicata,15367,13,22,2,37
Metapenaeus affinis,16027,13,22,2,37
Zele chlorophthalmus,16661,13,22,2,37
Ambystoma talpoideum,16358,13,22,2,37
Proechimys semispinosus calidior,16569,13,22,2,37
Hyoscyamus niger,501401,38,28,4,70
Microcebus murinus,17114,13,22,2,37
Potomida littoralis,15789,13,22,2,37
Lampsilis siliquoidea,16094,14,22,2,38
Pertusaria propinqua,79765,19,29,2,50
Cladonia apodocarpa,50682,18,22,2,42
Climacium americanum,105048,40,24,3,67
Anomodon rugelii,104239,46,24,3,73
Treubia lacunosa,151983,69,27,3,99
Phlegmariurus squarrosus,413530,147,34,6,187
Arabidopsis thaliana,367808,33,22,3,58
Montagnia macrospora,24875,23,22,3,48
Kumanoa ambigua,25862,22,16,3,41
Kumanoa mahlacensis,25069,23,19,3,45
Sirodotia delicatula,25150,25,18,3,46
Asterophora parasitica,43328,15,26,2,43
Blastosporella zonata,200401,56,31,4,91
Myochromella boudieri,99774,34,27,2,63
Tephrocybe rancida,126794,36,34,4,74
Tricholomella constricta,65087,16,27,2,45
Malassezia restricta,38720,16,24,2,42
Matuta planipes,15760,13,22,2,37
Pseudoniphargus carpalis,14861,13,22,2,37
Pseudoniphargus stocki,14697,13,22,2,37
Cheilopogon pinnatibarbatus,16532,13,22,2,37
Hirundichthys rondeletii,16524,13,22,2,37
Proechimys guairae,16614,13,22,2,37
Proechimys quadruplicatus,16819,13,22,2,37
Palaemon capensis,15925,13,22,2,37
Yunnanilus jinxiensis,16561,13,22,2,37
Limnadia lenticularis,15151,13,22,2,37
Ixos mcclellandii,17838,13,22,2,37
Anopheles splendidus,15362,13,22,2,37
Pericapritermes nitobei,15224,13,22,2,37
Linguatula serrata,15328,13,22,2,37
Cheilopogon spilonotopterus,16527,13,22,2,37
Trinorchestia longiramus,15401,13,22,2,37
Parhyale hawaiensis,15777,13,22,2,37
Hyalella azteca,15991,13,22,2,37
Dnopherula yuanmowensis,15629,13,22,2,37
Proechimys echinothrix,16756,13,22,2,37
Nannophya pygmaea,15112,13,22,2,37
Kaloula verrucosa,17061,13,22,2,37
Proechimys hoplomyoides,16648,13,22,2,37
Proechimys roberti,16812,13,22,2,37
Choristoneura conflictana,15541,13,22,2,37
Choristoneura pinus pinus,15536,13,22,2,37
Hyporhamphus quoyi,16525,13,22,2,37
Populicerus populi,16494,13,22,2,37
Paragonimus heterotremus,13927,12,22,2,36
Ovis nivicola lydekkeri,16471,13,22,2,37
Ovis dalli,16464,13,22,2,37
Thrips palmi,15333,13,22,2,37
Pristis pristis,16912,13,22,2,37
Proechimys simonsi,16754,13,22,2,37
Ligula intestinalis,13621,12,22,2,36
Digramma interrupta,13685,12,22,2,36
Histia rhodope,15209,13,22,2,37
Pseudocalotes microlepis,17873,13,22,2,37
Cassiopea xamachana,15949,15,2,2,19
Ceraesignum maximum,15578,13,22,2,37
Obscurella hidalgoi,15536,13,22,2,37
Monoplex parthenopeus,15270,13,22,2,37
Sarcophaga impatiens,15169,13,22,2,37
Bivetiella cancellata,16648,13,22,2,37
Tritia reticulata,15271,13,22,2,37
Nassarius variciferus,15269,13,22,2,37
Margarya oxytropoides,17044,13,22,2,37
Nepenthes ventricosa x Nepenthes alata,520764,37,18,3,58
Hygrophorus russula,55769,22,26,2,50
Styphnolobium japonicum,484916,32,21,3,56
Usnea mutabilis,61314,16,27,2,45
Babesia duncani,5893,3,0,6,9
Cladonia subtenuis,59878,19,26,2,47
Leucaena trichandra,722009,38,18,4,60
Eimeria furonis,6165,3,0,31,34
Pinus taeda,1191054,39,38,6,83
Hannaella oryzae,26444,17,23,2,42
Leiosporoceros dussii,212153,23,23,3,49
Chrysanthemum boreale,211002,32,19,3,54
Glycine soja,402545,88,20,2,110
Polytrichum commune,114831,40,24,3,67
Puccinia striiformis f. sp. tritici,101521,14,24,0,38
Ammopiptanthus mongolicus,475396,79,44,3,126
Cladonia leporina,50045,21,28,2,51
Cladonia petrophila,53100,17,25,2,44
Oxymeris dimidiata,16513,13,22,2,37
Colpocephalum griffoneae,14873,13,22,2,37
Echinostoma miyagawai,14416,12,22,2,36
Paruterina candelabraria,13634,12,22,2,36
Trichogramma japonicum,15962,13,22,2,37
Trichogramma ostriniae,16472,13,22,2,37
Psittiparus gularis,17109,13,22,2,37
Picumnus innominatus,17180,13,22,2,37
Niltava davidi,16770,13,22,2,37
Anopheles aconitus,15359,13,22,2,37
Diploderma flaviceps,17140,13,22,2,37
Chionodraco rastrospinosus,17598,13,22,2,37
Proechimys gardneri,16818,13,22,2,37
Proechimys goeldii,16784,13,22,2,37
Proechimys kulinae,16833,13,22,2,37
Proechimys mincae,16626,13,22,2,37
Proechimys pattoni,16814,13,22,2,37
Proechimys poliopus,16642,13,22,2,37
Proechimys steerei,16727,13,22,2,37
Proechimys trinitatis,16632,13,22,2,37
Bathymodiolus securiformis,17199,13,24,2,39
Sardinella lemuru,16616,13,22,2,37
Bourletiella arvalis,14794,13,22,2,37
Nilssonia nigricans,16796,13,22,2,37
Macrosteles quadrimaculatus,15734,13,22,2,37
Glyptothorax macromaculatus,16535,13,22,2,37
Perumytilus purpuratus,16464,13,25,2,40
Anoplolepis gracilipes,16943,13,22,2,37
Micronecta sahlbergii,15005,13,22,2,37
Paradoxurus hermaphroditus,16706,13,22,2,37
Caridina indistincta A,15461,13,22,2,37
Sinocyclocheilus tingi,16584,13,22,2,37
Epeorus herklotsi,15502,13,23,2,38
Lepidotrema longipenis,15433,12,22,2,36
Echinoecus nipponicus,16173,13,22,2,37
Mustelus mustelus,16755,13,22,2,37
Talpa occidentalis,16962,13,22,2,37
Hymenocera picta,15786,13,22,2,37
Palpita hypohomalia,15271,13,22,2,37
Orithyia sinica,15568,13,22,2,37
Thalamita sima,15831,13,22,2,37
Belzebub intermedius,16001,13,22,2,37
Idioscopus clypealis,15393,13,22,2,37
Cylicocyclus radiatus,13836,12,22,2,36
Pseudocrangonyx daejeonensis,15069,13,22,2,37
Bothrops pubescens,17694,13,23,2,38
Bothrops diporus,17642,13,22,2,37
Neolucanus maximus,16601,13,22,2,37
Pteromalus puparum,18217,13,23,2,38
Hycleus cichorii,15847,13,22,2,37
Tachaea chinensis,14616,13,21,2,36
Triaenodes tardus,14963,13,22,2,37
Cacoplistes rogenhoferi,16018,13,22,2,37
Meloimorpha japonica,15880,13,22,2,37
Ornebius bimaculatus,16136,13,22,2,37
Ornebius kanetataki,16589,13,22,2,37
Eudorcas thomsonii,16761,13,22,2,37
Neotoma magister,16310,13,22,2,37
Panulirus argus,15739,13,22,2,37
Laqueus japonicus,14267,13,22,2,37
Budorcas taxicolor tibetana,16665,13,22,2,37
Plutella australiana,15962,13,22,2,37
Ornithodoros sonrai,14430,13,22,2,37
Dichotomius schiffleri,14802,13,22,2,37
Adelpha iphiclus,15263,13,22,2,37
Athyma kanwa,15278,13,22,2,37
Parasarpa zayla,15269,13,22,2,37
Athyma jina,15202,13,22,2,37
Inflata indica,16150,13,22,2,37
Oostethus manadensis,16527,13,22,2,37
Glyptothorax laosensis,16539,13,22,2,37
Cyrtotrachelus buqueti,15035,13,21,2,36
Abscondita anceyi,16519,13,22,2,37
Apis andreniformis,16694,13,22,2,37
Ophraella communa,16553,13,22,2,37
Monolepta quadriguttata,16130,13,22,2,37
Aulacophora lewisii,15691,13,22,2,37
Ichthyoxenos japonensis,15440,13,21,2,36
Phryganea cinerea,15043,13,22,2,37
Appias remedios,15118,13,22,2,37
Ephestia elutella,15346,13,22,2,37
Macropus fuliginosus,16881,13,22,2,37
Oligoryzomys stramineus,16314,13,22,2,37
Asio otus,17555,13,22,2,37
Ornebius fuscicerci,16368,13,22,2,37
Idiocerus laurifoliae,16811,13,22,2,37
Mantella baroni,20945,13,24,2,39
Somena scintillans,15410,13,22,2,37
Sinocyclocheilus wumengshanensis,16585,13,22,2,37
Geospiza magnirostris,16798,13,22,2,37
Mantispa japonica,16106,13,22,2,37
Eumantispa harmandi,15741,13,22,2,37
Euclimacia badia,15899,13,22,2,37
Sebastes rubrivinctus,16895,13,22,2,37
Sebastes nigrocinctus,16922,13,22,2,37
Sebastes aleutianus,16977,13,22,2,37
Cyathocotyle prussica,13665,12,22,2,36
Grammodes geometrica,15728,13,22,2,37
Sperchon plumifer,14646,13,22,2,37
Atlantisia rogersi,17337,13,22,2,37
Lanius tigrinus,16817,13,22,2,37
Thryssa vitrirostris,16975,13,22,2,37
Tanakia latimarginata,16568,13,22,2,37
Carinotetraodon travancoricus,16487,13,22,2,37
Nemorilla maculosa,16638,13,22,2,37
Exorista civilis,15376,13,23,2,38
Sarcophaga dux,15731,13,22,2,37
Sarcophaga antilope,15196,13,22,2,37
Rhipicentor nuttalli,14779,13,22,2,37
Ornithodoros turicata,14458,13,22,2,37
Ornithodoros tholozani,14407,13,22,2,37
Ornithodoros parkeri,14437,13,22,2,37
Ornithodoros hermsi,14430,13,22,2,37
Parvasolenaia rivularis,16613,13,22,2,37
Dendrolimus houi,15381,13,22,2,37
Dendrolimus superans,15417,13,22,2,37
Falco amurensis,17464,13,22,2,37
Perdix perdix,16699,13,22,2,37
Octopus cyanea,15950,13,22,0,35
Callistoctopus luteus,15961,13,22,2,37
Semibalanus balanoides,15119,13,22,2,37
Ornithodoros coriaceus,14423,13,22,2,37
Adelpha ethelda,15350,13,22,2,37
Parasarpa zulema,15297,13,22,2,37
Moduza lysanias,15238,13,22,2,37
Chalinga pratti,15290,13,22,2,37
Limenitis weidemeyerii,15199,13,22,2,37
Limenitis glorifica,15177,13,22,2,37
Tacola eulimene,15669,13,22,2,37
Limenitis reducta,15175,13,22,2,37
Limenitis camilla,15129,13,22,2,37
Limenitis elwesi,15214,13,22,2,37
Limenitis archippus,15220,13,22,2,37
Limenitis arthemis,15279,13,22,2,37
Athyma pravara,15100,13,22,2,37
Limenitis ciocolatina,15214,13,22,2,37
Athyma punctata,15240,13,22,2,37
Athyma recurva,15189,13,22,2,37
Litinga mimica,15183,13,22,2,37
Parasarpa albomaculata,15272,13,22,2,37
Athyma disjuncta,15198,13,22,2,37
Litinga cottini,15205,13,22,2,37
Limenitis populi,15219,13,22,2,37
Athyma nefte,15438,13,22,2,37
Athyma fortuna,15192,13,22,2,37
Limenitis cleophas,15228,13,22,2,37
Auzakia danava,15367,13,22,2,37
Athyma ranga,15265,13,22,2,37
Limenitis lorquini,15228,13,22,2,37
Adelpha bredowii,15187,13,22,2,37
Athyma libnites,15216,13,22,2,37
Tacola larymna,15503,13,22,2,37
Anser albifrons frontalis,16740,12,22,2,36
Indicator maculatus,16841,13,22,2,37
Jynx ruficollis,16825,13,22,2,37
Megalaima virens,16788,13,22,2,37
Prodotiscus insignis,16811,13,22,2,37
Glyptothorax granosus,16540,13,22,2,37
Glyptothorax lanceatus,16541,13,22,2,37
Glyptothorax longinema,16537,13,22,2,37
Sanghuangporus sanghuang,112060,14,27,2,43
Synarthrophyton chejuense,28264,25,25,2,52
Neogoniolithon spectabile,26050,21,21,2,44
Parmotrema ultralucens,79456,14,26,2,42
Coniothyrium glycines,98533,35,30,2,67
Eucalyptus grandis,478813,38,20,4,62
Gymnomitrion concinnatum,162572,42,28,3,73
Gelidium gabrielsonii,24964,23,20,2,45
Gelidium kathyanniae,24963,23,20,2,45
Ulva expansa,64143,36,27,2,65
Hirsutella thompsonii,62509,30,27,2,59
Aspergillus luchuensis,31228,16,26,2,44
Conus betulinus,16240,13,22,2,37
Cervus elaphus kansuensis,16430,13,22,2,37
Periplaneta brunnea,15604,13,22,2,37
Tridacna derasa,20760,13,23,2,38
Apostictopterus fuliginosus,15417,13,22,2,37
Barca bicolor,15574,13,22,2,37
Suhpalacsa longialata,15911,13,22,2,37
Orancistrocerus aterrimus,17972,13,23,2,38
Rhyticeros undulatus,17842,13,22,2,37
Cerithidea obtusa,15708,13,22,2,37
Arcyptera meridionalis,15776,13,22,2,37
Clemelis pullata,15225,13,22,2,37
Pleoticus muelleri,16189,13,22,2,37
Mongoloniscus sinensis,16018,13,19,2,34
Xiphidiopsis gurneyi,16225,13,22,2,37
Freyastera benthophila,16175,13,22,2,37
Lasiommata deidamia,15244,13,22,2,37
Ochotona koslowi,16909,13,22,2,37
Aphis fabae mordvilkoi,15346,13,22,2,37
Parasesarma affine,15638,13,22,2,37
Gobiopterus lacustris,16593,13,22,2,37
Ardea insignis,18656,13,23,2,38
Indicator xanthonotus,17603,13,22,2,37
Erythrogenys gravivox,16963,13,22,2,37
Stereobalanus canadensis,17366,13,23,2,38
Schizocardium brasiliense,15416,13,22,2,37
Glossobalanus marginatus,16827,13,22,2,37
Cosmoscarta bispecularis,15024,13,22,2,37
Cosmoscarta dorsimacula,15677,13,22,2,37
Parabreviscolex niepini,15034,12,22,2,36
Chiroteuthis picteti,20851,18,23,2,43
Roisinitermes ebogoensis,15933,13,22,2,37
Simulium maculatum,15799,13,22,2,37
Tremex columba,16397,13,22,2,37
Portunus gracilimanus,15990,13,22,2,37
Alveopora japonica,18144,13,2,2,17
Montipora efflorescens,17886,13,2,2,17
Neodon fuscus,16328,13,22,2,37
Metapenaeopsis barbata,15973,13,22,2,37
Penaeus latisulcatus,15971,13,22,2,37
Cacatua pastinator,19041,14,25,2,41
Ophioplinthus gelida,18387,13,22,2,37
Astrotoma agassizii,16464,13,22,2,37
Gorgonocephalus chilensis,16361,13,22,2,37
Ophioceres incipiens,18107,13,22,2,37
Ophionotus victoriae,15932,13,22,2,37
Ophioplinthus brevirima,15967,13,23,2,38
Ophiosteira antarctica,16979,13,22,2,37
Eolophus roseicapillus,18982,13,24,2,39
Hydrodamalis gigas,16872,13,22,2,37
Halichondria panicea,19571,14,25,2,41
Echinophyllia aspera,17697,13,3,2,18
Bremia lactucae,39302,42,26,2,70
Clavelina oblonga,14603,13,24,2,39
Penion maximus,15249,13,22,2,37
Clithon retropictum,15814,13,22,2,37
Halcampoides purpureus,18038,15,2,2,19
Cladosiphon okamuranus,38419,37,24,3,64
Podospora comata,82766,42,27,2,71
Homogryllacris anelytra,15706,13,22,2,37
Limnonectes fujianensis,18293,13,23,2,38
Mesoplodon europaeus,16343,13,22,2,37
Mesoplodon densirostris,16347,13,22,2,37
Onchocerca ochengi,13744,12,22,2,36
Apis laboriosa,15510,13,22,2,37
Gecarcoidea natalis,15545,13,22,2,37
Gorilla gorilla,16364,13,22,2,37
Homo sapiens neanderthalensis,16565,13,22,2,37
Epinephelus moara x Epinephelus tukula,16695,13,22,2,37
Saccharina japonica x Saccharina longissima,37657,38,24,3,65
Gallus gallus spadiceus,16784,13,22,2,37
Peromyscus maniculatus bairdii,16322,13,22,2,37
Hirsutella rhossiliensis,62483,24,26,2,52
Oenanthe isabellina,16812,13,22,2,37
Nycticebus coucang insularis,16765,13,22,2,37
Heterorhabditis indica,18128,12,22,2,36
Ceratophyllus wui,18081,13,22,2,37
Homatula berezowskii,16570,13,22,2,37
Microphysogobio sp. XZ-2015,16607,13,22,2,37
Chrysiptera biocellata,16935,13,22,2,37
Lophophorus impejanus,16709,13,22,2,37
Heterocarpus ensifer,15939,13,22,2,37
Bitias brevis,15891,13,22,2,37
Mesabolivar sp. ITV1036I1,14941,13,22,2,37
Mesabolivar sp. ITV1036I3,14727,13,22,2,37
Cheilodipterus quinquelineatus,16537,13,22,2,37
Chaetodon octofasciatus,16485,13,22,2,37
Parus major,16777,13,22,2,37
Schizosaccharomyces cryophilus,32669,12,24,2,38
Paravannella minima,53464,45,23,2,70
Conidiobolus heterosporus,53364,37,26,2,65
Gelidium coulteri,24963,23,20,2,45
Eleusine indica,520691,34,24,6,64
Acacia ligulata,698138,38,22,3,63
Rattus nitidus,16297,13,22,2,37
Triodia sylvina,15040,13,22,2,37
Mobula tarapacana,15686,13,22,2,37
Myllocerinus aurolineatus,17762,13,22,2,37
Buccinum undatum,15265,13,22,2,37
Rhagologus leucostigma,17044,13,22,2,37
Acanthopagrus schlegelii x Pagrus major,16649,13,22,2,37
Benthodytes marianensis,17567,13,22,2,37
Partulina redfieldi,16879,13,22,2,37
Nagiella inferior,15348,13,22,2,37
Xizicus maculatus,16358,13,22,2,37
Carpodacus rubicilloides,16805,13,22,2,37
Metaplax longipes,16305,13,22,2,37
Nanosesarma minutum,15637,13,22,2,37
Mergus merganser,16630,13,22,2,37
Euphausia superba,16591,13,21,2,36
Calidris ruficollis,16860,13,22,2,37
Yuhina nigrimenta,17817,13,22,2,37
Holbrookia lacerata,16705,13,22,2,37
Ulva compressa,62477,43,28,2,73
Populus alba,838420,54,22,3,79
Chenopodium quinoa,315003,30,21,3,54
Morus notabilis,362069,26,25,3,54
Greenidea psidii,16202,13,22,2,37
Haliaeetus albicilla,17719,13,22,2,37
Heterobasidion irregulare,114193,28,26,2,56
Guaruba guarouba,17008,13,22,2,37
Aratinga solstitialis,16984,13,22,2,37
Orbilia oligospora,160613,56,24,2,82
Drechslerella brochopaga,193195,79,22,2,103
Gyrodactylus gurleyi,14771,12,22,2,36
Corvus cornix cornix,16946,13,22,2,37
Elaphe dione,17172,13,22,2,37
Sarcophaga ruficornis,14938,13,22,2,37
Oxysarcodexia avuncula,14997,13,22,2,37
Oxysarcodexia terminalis,15613,13,22,2,37
Oxysarcodexia thornax,15237,13,22,2,37
Oxysarcodexia varia,15261,13,22,2,37
Dolichoderus sibiricus,16086,13,22,2,37
Haemaphysalis bancrofti,14673,13,22,2,37
Peckia resona,15122,13,22,2,37
Peckia australis,15205,13,22,2,37
Peckia collusor,15233,13,22,2,37
Liriomyza chinensis,16175,13,22,2,37
Gigantometra gigas,15348,13,22,2,37
Ixodes tasmani,15227,13,22,2,37
Trouessartia rubecula,14125,13,17,2,32
Chloris sinica,16812,13,22,2,37
Turdus kessleri,16754,13,22,2,37
Geochelone elegans,16446,13,22,2,37
Engraulis mordax,16664,13,22,2,37
Muntiacus feae,16355,13,22,2,37
Zophobas atratus,15494,13,22,2,37
Scopura longa,15798,13,22,2,37
Hydrillodes lentalis,15570,13,22,2,37
Pentacheles validus,16079,13,22,2,37
Anthus richardi,16871,13,22,2,37
Cardellina canadensis,16807,13,22,2,37
Clania variegata,15660,13,22,2,37
Traulia nigritibialis,15701,13,22,2,37
Stenocatantops splendens,15574,13,22,2,37
Choroedocus capensis,16293,13,22,2,37
Charadrius alexandrinus,16905,13,22,2,37
Cheliceroides longipalpis,14334,13,22,2,37
Yungipicus canicapillus,16843,13,22,2,37
Sitotroga cerealella,15312,13,22,2,37
Sphenomorphus incognitus,17417,13,22,2,37
Clostera anastomosis,15390,13,22,2,37
Trochalopteron milnei,17871,13,22,2,37
Pomacea diffusa,16373,13,22,2,37
Eristalis tenax,15996,13,22,2,37
Uropsilus andersoni,16528,13,22,2,37
Blarinella wardi,16951,13,22,2,37
Isopachys gyldenstolpei,17210,13,22,2,37
Parnassius apollonius,15381,13,22,2,37
Alpheus inopinatus,15789,13,22,2,37
Gebiacantha plantae,16771,13,22,2,37
Ibacus alticrenatus,15762,13,22,2,37
Ombrastacoides huonensis,17559,13,22,2,37
Puerulus angulatus,15688,13,22,2,37
Remiarctus bertholdii,15807,13,22,2,37
Thalassina squamifera,15532,13,22,2,37
Upogebia bowerbankii,15836,13,22,2,37
Nyctalus plancyi,17494,13,22,2,37
Glossaulax reiniana,15254,13,22,2,37
Gavia arctica,17066,13,22,2,37
Hoplasoma unicolor,14568,13,22,2,37
Macrohaltica subplicata,15840,13,22,2,37
Chaetocnema pelagica,16331,13,22,2,37
Henosepilachna vigintioctopunctata,17057,13,22,2,37
Encyrtus infelix,15698,13,22,2,37
Abudefduf bengalensis,16776,13,22,2,37
Acentrogobius caninus,16614,13,22,2,37
Halichoeres nigrescens,17252,13,22,2,37
Paratrypauchen microcephalus,16552,13,22,2,37
Chromodoris orientalis,14266,13,22,2,37
Artamus cinereus,16896,13,22,2,37
Cryptopone sauteri,15367,13,22,2,37
Neoeriocheir leptognathus,16143,13,22,2,37
Chiromantes dehaani,15917,13,22,2,37
Xenogryllus marmoratus,15762,13,23,2,38
Sitona obsoletus,17003,13,22,2,37
Precis andremiaja,15239,13,22,2,37
Salamis anteva,15201,13,22,2,37
Gasterosteus aculeatus,16543,13,22,2,37
Microtus agrestis,16297,13,22,2,37
Oceanodroma castro,17065,13,22,2,37
Psittacara leucophthalmus,16966,13,22,2,37
Elseya irwini,16480,13,22,2,37
Elseya lavarackorum,16485,13,22,2,37
Chelodina novaeguineae,16510,13,22,2,37
Chelodina burrungandjii,16520,13,22,2,37
Chelodina canni,16503,13,22,2,37
Elseya albagula,16441,13,22,2,37
Elseya dentata,16439,13,22,2,37
Elseya novaeguineae,16443,13,22,2,37
Elseya schultzei,16447,13,22,2,37
Chelodina colliei,16508,13,22,2,37
Chelodina steindachneri,16599,13,22,2,37
Emydura macquarii,16470,13,22,2,37
Kogia sima,16403,13,22,2,37
Narosa nigrisigna,15292,13,22,2,37
Umbonium thomasi,15998,13,22,2,37
Johnius borneensis,18630,13,25,2,40
Nassarius conoidalis,15332,13,22,2,37
Nassarius pullus,15278,13,22,2,37
Aspergillus pseudoglaucus,53882,30,26,2,58
Chlorosarcinopsis eremi,24905,7,3,9,19
Arthrobotrys musiformis,179060,72,18,1,91
Aspergillus parasiticus,29141,17,26,2,45
Orbilia dorsalia,191042,21,25,2,48
Cordyceps cicadae,56581,43,25,2,70
Guillardia theta,35013,36,27,2,65
Cynanchum auriculatum,426495,25,19,3,47
Vischeria stellata,42608,36,26,3,65
Dactylellina haptotyla,146101,19,26,1,46
Corallina ferreyrae,25953,23,23,2,48
[Candida] haemuloni,39519,0,0,0,0
Tragulus napu,15779,13,22,2,37
Plasmodium gonderi,5999,3,0,0,3
Dasyhippus barbipes,16111,13,22,2,37
Otus sunia,17835,13,22,2,37
Podagricomela nigricollis,16756,13,22,2,37
Macromia daimoji,15198,13,22,2,37
Pseudis tocantins,15564,13,22,2,37
Hippocampus camelopardalis,16523,13,22,2,37
Pseudobagrus pratti,16533,13,22,2,37
Styracaster yapensis,16360,13,22,2,37
Elephantulus edwardii,16552,13,22,2,37
Crotalus adamanteus,17242,13,22,2,37
Nassarius sinarum,15325,13,22,2,37
Nassarius foveolatus,15343,13,22,2,37
Nassarius javanus,15325,13,22,2,37
Nassarius jacksonianus,15234,13,22,2,37
Polyplacotoma mediterranea,23462,12,25,3,40
Hydrophasianus chirurgus,16855,13,22,2,37
Gallirallus striatus,17647,13,22,2,37
Rallus aquaticus,17149,13,22,2,37
Myotis frater,17089,13,22,2,37
Ectophylla alba,16656,13,22,2,37
Jaydia lineata,16506,13,22,2,37
Magicicada septendecim,14436,13,22,2,37
Magicicada neotredecim,14435,13,22,2,37
Magicicada tredecim,14435,13,22,2,37
Magicicada cassinii,14713,13,22,2,37
Magicicada tredecassini,14864,13,22,2,37
Magicicada septendecula,14453,13,22,2,37
Magicicada tredecula,14453,13,22,2,37
Palesisa nudioculata,16476,13,22,2,37
Piranga roseogularis,16782,13,22,2,37
Piranga rubra,16805,13,22,2,37
Piranga lutea,16803,13,22,2,37
Piranga flava,16814,13,22,2,37
Piranga hepatica,16806,13,22,2,37
Piranga olivacea,16810,13,22,2,37
Piranga ludoviciana,16804,13,22,2,37
Piranga bidentata,16808,13,22,2,37
Piranga erythrocephala,16802,13,22,2,37
Piranga rubriceps,16809,13,22,2,37
Piranga leucoptera,16795,13,22,2,37
Alcidodes juglans,15638,13,21,2,36
Sarotherodon linnellii,16634,13,22,2,37
Pungu maclareni,16565,13,22,2,37
Myaka myaka,16626,13,22,2,37
Konia dikume,16618,13,22,2,37
Sarotherodon lohbergeri,16634,13,22,2,37
Stomatepia pindu,16636,13,22,2,37
Boechera stricta,271601,31,21,3,55
Balbiania investiens,26389,25,23,1,49
Lecanora saxigena,56579,14,25,2,41
Lecanora cinereofusca,32357,14,25,2,41
Heterodermia casarettiana,84088,16,28,2,46
Hypsizygus marmoreus,102752,27,27,2,56
Armillaria sinapina,103563,44,25,2,71
Armillaria borealis,116433,47,26,2,75
Armillaria solidipes,122167,49,26,2,77
Helix pomatia,14072,13,22,2,37
Cylicodontophorus bicoronatus,13756,12,22,2,36
Chiromantes haematocheir,15899,13,22,2,37
Cydalima perspectalis,15232,13,22,2,37
Aristobia reticulator,15838,13,22,2,37
Metopograpsus frontalis,15587,13,22,2,37
Isonychia kiangsinensis,15456,13,22,2,37
Trichiurus haumela,16855,13,21,2,36
Bullacta exarata,13872,13,22,2,37
Metapenaeus joyneri,16008,13,22,2,37
Saccharosydne procerus,16031,13,22,2,37
Sogatella vibix,16554,13,22,2,37
Myoxocephalus scorpius,16626,13,22,2,37
Culicicapa ceylonensis,16851,13,22,2,37
Salvelinus fontinalis x Salvelinus malma,16622,13,22,2,37
Sorex minutissimus,17038,13,22,2,37
Callispa bowringii,17060,13,22,2,37
Antarctoperla michaelseni,16069,13,22,2,37
Neuroperla schedingi,16882,13,22,2,37
Erthesina fullo,16485,13,22,2,37
Etheostoma spectabile,16539,13,22,2,37
Diamphipnoa annulata,14882,13,22,2,37
Neonemura barrosi,14852,13,22,2,37
Rhopalopsole bulbifera,15599,13,22,2,37
Etisus anaglyptus,16435,13,22,2,37
Yunnanilus sichuanensis,16571,13,22,2,37
Euchiloglanis davidi,16569,13,22,2,37
Ompok pabda,16512,13,22,2,37
Channa punctata,16409,13,22,2,37
Astictopterus jama,15430,13,22,2,37
Isoteinon lamprospilus,15430,13,22,2,37
Notocrypta curvifascia,15546,13,22,2,37
Mesoplodon mirus,16342,13,22,2,37
Mesoplodon bidens,16347,13,22,2,37
Rana temporaria,16061,13,22,2,37
Numenius tenuirostris,16705,13,22,2,37
Paralithodes platypus,16883,13,22,2,37
Marmota flaviventris,16438,13,22,2,37
Rheodytes leukops,16460,13,22,2,37
Etheostoma flabellare,16656,13,22,2,37
Lepomis gulosus,16486,13,22,2,37
Carcharhinus falciformis,16677,13,22,2,37
Hoplobatrachus chinensis x Hoplobatrachus rugulosus,20282,14,23,2,39
Hyporhamphus dussumieri,16542,13,22,2,37
Hyporhamphus limbatus,16508,13,22,2,37
[Candida] duobushaemulonis,22443,0,0,0,0
Synchytrium endobioticum,72775,19,5,2,26
Lactuca serriola,363328,37,25,6,68
Nereocystis luetkeana,37399,37,24,2,63
Lactuca saligna,368269,39,25,6,70
Phlyctis petraea,49698,15,24,2,41
Adrisa magna,15935,13,22,2,37
Pseudoperonospora humuli,39087,40,25,2,67
Chloropicon primus,37892,35,25,2,62
Picocystis salinarum,41858,36,26,4,66
Chloropicon laureae,37769,35,25,2,62
Ameiurus nebulosus,16513,13,22,2,37
Pseudophyllus titan,16227,13,22,2,37
Truljalia hibinonis,15120,13,22,2,37
Oecanthus sinensis,16142,13,22,2,37
Chloropicon sieburthii,37591,35,25,2,62
Chloropicon roscoffensis,38736,34,25,2,61
Chloropicon mariensis,35545,34,25,2,61
Chloroparvula japonica,40432,36,24,2,62
Chloropicon maureeniae,36041,36,25,2,63
Chloroparvula pacifica,49744,38,25,2,65
Macrocystis integrifolia,37366,37,24,3,64
Rhizopogon salebrosus,66704,34,25,2,61
Rhizopogon vinicolor,77109,41,25,2,68
Lactuca sativa,363324,37,25,6,68
Schisandra sphenanthera,1101768,43,22,5,70
Desarmillaria tabescens,93439,15,26,2,43
Taiwanofungus camphoratus,114922,57,27,2,86
Laccaria amethystina,65156,23,25,2,50
Laccaria bicolor,95304,29,25,2,56
Cladonia macilenta,46553,15,19,2,36
Dumortiera hirsuta,178019,41,28,3,72
Synchytrium microbalum,23811,14,5,2,21
Spizellomyces sp. 'palustris',126474,41,12,2,55
Chytriomyces confervae,225604,18,7,2,27
Capsella rubella,287405,32,22,3,57
Corallina chilensis,25895,25,23,2,50
Dactylella tenuis,186056,74,24,2,100
Conepatus chinga,16513,13,22,2,37
Moschus leucogaster,16431,13,22,2,37
Poecilimon luschani,15568,13,22,2,37
Isophya major,15724,13,22,2,37
Gerbilliscus leucogaster,16332,13,22,2,37
Parantica aglea,15219,13,22,2,37
Camponotus concavus,16357,13,22,2,37
Micromus angulatus,16153,13,22,2,37
Ectomomyrmex javanus,15512,13,22,2,37
Tetraphleps aterrimus,15803,13,22,2,37
Panstrongylus rufotuberculatus,16331,13,22,2,37
Dendrocopos darjellensis,16864,13,22,2,37
Stolephorus waitei,16681,13,22,2,37
Pseudohelice subquadrata,16898,13,22,2,37
Notospermus geniculatus,15180,13,23,2,38
Acisoma panorpoides,15742,13,22,2,37
Deielia phaon,15281,13,22,2,37
Tramea virginia,15321,13,22,2,37
Blarina hylophaga,16755,13,22,2,37
Ovalipes punctatus,16084,13,22,2,37
Bactrocera biguttula,15829,13,22,2,37
Sinorhodeus microlepis,16591,13,22,2,37
Chrysichthys nigrodigitatus,16514,13,22,2,37
Uvitellina sp. SSS-2019,14217,12,22,2,36
Macropsis notata,16323,13,22,2,37
Engraulis ringens,16690,13,22,2,37
Stolephorus insularis,16711,13,22,2,37
Sitta himalayensis,16822,13,22,2,37
Sitta nagaensis,16828,13,22,2,37
Orthetrum melania,15715,13,22,2,37
Trigomphus carus,15135,13,22,2,37
Blarina brevicauda,16919,13,22,2,37
Megalonyx jeffersonii,15450,13,22,2,37
Megatherium americanum,15461,13,22,2,37
Amphiura digitula,16291,13,22,2,37
Pisaster ochraceus,16376,13,22,2,37
Acropora valida,18385,13,2,2,17
Pantherina griselda,16968,13,22,2,37
Blarinella cf. quadraticauda KIZ AL11069,17130,13,22,2,37
Acratocnus ye,15385,13,21,2,36
Nothrotheriops shastensis,15448,13,22,2,37
Parocnus serus,15449,13,22,2,37
Sinella curviseta,14840,13,22,2,37
Sarcophaga princeps,15981,13,22,2,37
Steno bredanensis,16386,13,22,2,37
Crocidura fuliginosa,16967,13,22,2,37
Dermacentor everestianus,15191,13,22,2,37
Psittacula eupatria,17139,13,22,2,37
Andrena chekiangensis,15804,13,22,2,37
Fucellia costalis,16175,13,22,2,37
Eleotris klunzingerii,16557,13,22,2,37
Gasterophilus haemorrhoidalis,14854,13,22,2,37
Gasterophilus inermis,14854,13,22,2,37
Gasterophilus nasalis,15191,13,22,2,37
Hippocampus capensis,16529,13,22,2,37
Cypridina dentata,15779,13,22,2,37
Hydnophora exesa,17790,13,2,2,17
Polypedates braueri,19904,12,22,2,36
Hoplistodera incisa,14932,13,22,2,37
Scoparipes salvazai,15173,13,22,2,37
Anaxandra taurina,16694,13,22,2,37
Brachymna tenuis,15744,13,22,2,37
Cantao ocellatus,15952,13,22,2,37
Catacanthus incarnatus,15939,13,22,2,37
Caystrus obscurus,15896,13,22,2,37
Cloresmus pulchellus,18022,13,22,2,37
Molipteryx lunata,16660,13,22,2,37
Eurygaster testudinaria,16401,13,22,2,37
Leptoglossus membranaceus,15738,13,22,2,37
Megymenum gracilicorne,15604,13,22,2,37
Mictis tenebrosa,16433,13,22,2,37
Placosternum urus,16233,13,22,2,37
Plautia fimbriata,15907,13,22,2,37
Pseudomictis brevicornis,15826,13,22,2,37
Scotinophara lurida,15919,13,22,2,37
Eocanthecona thomsoni,14782,13,22,2,37
Cazira horvathi,15939,13,22,2,37
Menida violacea,15379,13,22,2,37
Rhyzopertha dominica,15859,13,22,2,37
Phodopus sungorus,16346,13,22,2,37
Oomorphoides metallicus,16462,13,22,2,37
Epeus alboguttatus,14625,13,22,2,37
Altica fragariae,16220,13,22,2,37
Altica cirsicola,15864,13,22,2,37
Triatoma migrans,17323,13,22,2,37
Gephyrocharax atracaudatus,17049,13,22,2,37
Loxosceles similis,14683,12,22,2,36
Diabolocatantops pinguis,15604,13,22,2,37
Pseudosuccinea columella,13757,13,22,2,37
Eristalinus fuscicornis,15815,13,22,2,37
Eristalinus barclayi,15757,13,22,2,37
Eristalinus vicarians,15966,13,22,2,37
Eristalinus tabanoides,15792,13,22,2,37
Eristalinus aeneus,16245,13,22,2,37
Lutjanus vitta,16498,13,22,2,37
Myotragus balearicus,16637,13,22,2,37
Diorhabda carinata,16232,13,22,2,37
Diorhabda carinulata,16298,13,22,2,37
Hydrotaea spinigera,15576,13,22,2,37
Synthesiomyia nudiseta,15117,13,22,2,37
Fossombronia foveolata,175222,42,27,3,72
Metzgeria furcata,171891,42,28,3,73
Haplomitrium hookeri,174448,43,27,3,73
Riccia fluitans,185621,42,28,3,73
Ptilidium ciliare,179562,42,28,3,73
Porella platyphylla,179081,42,28,3,73
Solenostoma sphaerocarpum,156050,42,27,3,72
Dictyopteris divaricata,32021,38,24,3,65
Paecilomyces penicillatus,27480,17,24,2,43
Orbicella annularis,16138,13,2,2,17
Athyma gutama,15266,13,22,2,37
Orbicella franksi,16137,13,2,2,17
Goniopora columna,18766,13,2,2,17
Archaeocroton sphenodonti,14772,13,22,2,37
Robertsicus elaphensis,14627,13,22,2,37
Daucus carota subsp. sativus,281132,90,25,4,119
Isopora togianensis,18637,13,2,2,17
Isopora palifera,18725,13,2,2,17
Astreopora myriophthalma,18106,13,2,2,17
Turbinaria peltata,18966,13,2,2,17
Odorrana livida,16057,13,22,2,37
Hydatophylax nigrovittatus,15048,13,22,2,37
Phryganopsyche latipennis,15167,13,22,2,37
Mecistocephalus marmoratus,15279,13,22,2,37
Oxya japonica,15427,13,22,2,37
Oreohelix idahoensis,14213,13,22,2,37
Poroderma pantherinum,16686,13,22,2,37
Axianassa australis,15738,13,22,2,37
Laomedia healyi,15834,13,22,2,37
Polycheles baccatus,16880,13,22,2,37
Strahlaxius plectrorhynchus,15816,13,22,2,37
Margaritifera margaritifera,16122,13,22,2,37
Dacus conopsoides,15852,13,23,2,38
Rhodnius pictipes,15908,13,22,2,37
Misgurnus anguillicaudatus x Misgurnus bipartitus,16647,13,22,2,37
Lovettia sealii,16542,13,22,2,37
Leiopotherapon unicolor,16493,13,22,2,37
Bothrocara hollandi,16732,13,22,2,37
Amblypharyngodon mola,16545,13,22,2,37
Neocaridina davidi koreana,15558,13,22,2,37
Amblyomma javanense,14780,13,22,2,37
Uranoscopus cognatus,16578,13,22,2,37
Porcula salvania,16682,13,22,2,37
Glenea cantor,15514,13,22,2,37
Arctictis binturong albifrons,16642,13,22,2,37
Aphis citricidus,16763,13,22,2,37
Sinocyclocheilus qujingensis,16588,13,22,2,37
Papilio memnon,15262,13,22,2,37
Lutjanus fulviflamma,16512,13,22,2,37
Scolopsis ciliata,16733,13,22,2,37
Amblyglyphidodon curacao,16612,13,22,2,37
Chthamalus challengeri,15358,13,22,2,37
Dicrurus hottentottus,16963,13,22,2,37
Tetrao parvirostris parvirostris,16688,13,22,2,37
Tetrao parvirostris kamtschaticus,16684,13,22,2,37
Polypedates megacephalus,19952,12,22,2,36
Ceracris fasciata fasciata,15569,13,22,2,37
Lessonia spicata,37097,38,25,3,66
Astreopora explanata,18106,13,2,2,17
Cylicocyclus auriculatus,13831,12,22,2,36
Hypseleotris klunzingeri,16508,13,22,2,37
Nematalosa erebi,16665,13,22,2,37
Craterocephalus stramineus,16566,13,22,2,37
Glyptelasma annandalei,16107,13,22,2,37
Daption capense,17312,13,22,2,37
Takifugu obscurus x Takifugu rubripes,16443,13,22,2,37
Budorcas taxicolor taxicolor,16584,13,22,2,37
Puccinia triticina,77894,14,23,0,37
Austropuccinia psidii,93299,45,23,2,70
Pseudocercospora fijiensis,74089,28,38,2,68
Physochlaina orientalis,684857,37,24,4,65
Gopherus evgoodei,16845,13,22,2,37
Pachypanchax playfairii,16561,13,22,2,37
Gloiopeltis furcata,25636,24,23,2,49
Ramalina intermedia,30678,15,25,2,42
Fusarium bambusae,63593,15,27,2,44
Haslea nusantara,36288,36,23,2,61
Codonopsis lanceolata,403704,31,20,3,54
Setaria labiatopapillosa,13950,12,22,2,36
Sinocyclocheilus huizeensis,16585,13,22,2,37
Dipsastraea rotumana,16466,13,2,2,17
Percina brevicauda,16608,13,22,2,37
Distichoptilum gracile,19171,14,1,2,17
Funiculina quadrangularis,18906,14,1,2,17
Harpactocrates apennicola,14213,13,22,2,37
Poicephalus senegalus,18022,13,22,2,37
Anthoptilum grandiflorum,18853,14,1,2,17
Pennatula aculeata,18715,14,1,2,17
Pennatula grandis,18973,14,1,2,17
Protoptilum carpenteri,18729,14,1,2,17
Virgularia mirabilis,18770,14,1,2,17
Timarete posteria,15497,13,23,2,38
Octopus mimus,15696,13,22,2,37
Gordionus alpestris,15132,13,22,2,37
Serrognathus platymelus,16790,13,22,2,37
Dentex angolensis,16581,13,22,2,37
Parachtes romandiolae,14220,13,22,2,37
Neoscona scylla,14092,13,22,2,37
Lutjanus carponotatus,16514,13,22,2,37
Sorex daphaenodon,17407,13,23,2,38
Ophioplocus japonicus,16144,13,22,2,37
Chamberlainia hainesiana,16746,13,22,2,37
Microcondylaea bonellii,16020,13,22,2,37
Monodontina vondembuschiana,16028,13,22,2,37
Ochotona dauurica,17293,13,22,2,37
Pilsbryoconcha exilis,16168,13,22,2,37
Anolis punctatus,17132,13,22,2,37
Mytilisepta keenae,15902,12,23,2,37
Crenomytilus grayanus,17582,13,23,2,38
Gregariella coralliophaga,16273,13,23,2,38
Modiolus nipponicus,15638,12,22,2,36
Septifer bilocularis,16253,13,23,2,38
Dicyrtomina saundersi,15045,13,22,2,37
Tracheophilus cymbius,13760,12,22,2,36
Sicyopterus aiensis,16500,13,22,2,37
Sicyopterus cynocephalus,16505,13,22,2,37
Sicyopterus eudentatus,16502,13,22,2,37
Sicyopterus franouxi,16498,13,22,2,37
Sicyopterus lengguru,16500,13,22,2,37
Sicyopterus lividus,16499,13,22,2,37
Sicyopterus longifilis,16503,13,22,2,37
Sicyopterus marquesensis,16501,13,22,2,37
Sicyopterus microcephalus,16496,13,22,2,37
Sicyopterus parvei,16502,13,22,2,37
Eustenogaster scitula,17867,13,22,2,37
Stiphodon tuivi,16508,13,22,2,37
Sicyopterus squamosissimus,16500,13,22,2,37
Sicyopterus stiphodonoides,16497,13,22,2,37
Stiphodon pelewensis,16504,13,22,2,37
Sicyopterus pugnans,16496,13,22,2,37
Sicyopterus punctissimus,16496,13,22,2,37
Sicyopterus sarasini,16501,13,22,2,37
Sicyopterus stimpsoni,16497,13,22,2,37
Pionites leucogaster,18858,13,22,2,37
Lateolabrax japonicus,16593,13,22,2,37
Bombina bombina,17154,13,22,2,37
Psittacula derbiana,16887,13,22,2,37
Gonioctena intermedia,18293,13,22,2,37
Austruca lactea,15659,13,22,2,37
Acheilognathus tonkinensis,16767,13,22,2,37
Schistodesmus lampreyanus,15855,13,22,2,37
Plagiorchis maculosus,14124,12,22,2,36
Nocomis micropogon,16655,13,22,2,37
Ectopistes migratorius,17026,13,22,2,37
Plesiastrea versipora,15320,13,2,2,17
Psolodesmus mandarinus,15176,13,22,2,37
Scoliodon laticaudus,16695,13,22,2,37
Acuticosta chinensis,15652,13,22,2,37
Cuneopsis capitatus,15845,13,22,2,37
Cuneopsis heudei,15892,13,22,2,37
Melamphaus rubrocinctus,16828,13,22,2,37
Physopelta cincticollis,16191,13,22,2,37
Protosalanx chinensis,16879,13,22,2,37
Alvinocaris longirostris,16022,13,22,2,37
Reticulitermes leptomandibularis,15920,13,22,2,37
Etheostoma olmstedi,16639,13,22,2,37
Aiolocaria hexaspilota,17549,13,22,2,37
Emydura victoriae,16447,13,22,2,37
Heterakis dispar,13995,12,22,2,36
Pyrrhopeplus posthumus,16192,13,22,2,37
Melamphaus faber,17250,13,22,2,37
Emydura tanybaraga,16442,13,22,2,37
Dysdercus evanescens,15776,13,22,2,37
Myuchelys latisternum,16485,13,22,2,37
Myuchelys georgesi,16490,13,22,2,37
Hiatula chinensis,16333,12,22,2,36
Gari elongata,16766,12,22,2,36
Malayopython reticulatus,17641,13,22,2,37
Antilochus coquebertii,15970,13,22,2,37
Dysdercus decussatus,16513,13,22,2,37
Physopelta slanbuschii,16502,13,22,2,37
Antilochus russus,15924,13,22,2,37
Dindymus rubiginosus,16213,13,22,2,37
Euscopus rufipes,16355,13,22,2,37
Pyrrhopeplus carduelis,16762,13,22,2,37
Saccharina sp.,37657,38,24,3,65
Sinularia ceramensis,18740,14,1,2,17
Sanguinolaria ovalis,16460,12,22,2,36
Hiatula acuta,16352,13,22,2,37
Labriocimbex sinicus,15405,13,22,2,37
Montifringilla henrici,16924,13,22,2,37
Cobitis nalbanti,16631,13,22,2,37
Cyprinus carpio x Megalobrama amblycephala,16580,13,22,2,37
Epinephelus fuscoguttatus x Epinephelus tukula,16629,13,22,2,37
Hystrichopsylla weida qinlingensis,17173,13,22,2,37
Gyrostigma rhinocerontis,15826,13,22,2,37
Haemaphysalis hystricis,14716,13,22,2,37
Artemia franciscana,15822,13,22,2,37
Vespa velutina,16416,13,22,2,37
Actinia equina,20690,14,2,2,18
Cafileria marina,42797,38,21,2,61
Haematococcus lacustris,124604,7,2,9,18
Porodaedalea pini,144970,115,26,2,143
Fomitiporia mediterranea,115036,81,27,2,110
Phellinus lamaoensis,45604,33,26,2,61
Coniferiporia sulphurascens,58959,45,25,2,72
Schizopora paradoxa,57732,39,26,2,67
Inonotus obliquus,119110,58,30,2,90
Prunus avium,389709,25,16,3,44
Trichoderma reesei,42130,19,23,2,44
Trichoderma gamsii,29303,18,26,2,46
Dolomedes angustivirgatus,14783,13,22,2,37
Exorista japonica,17663,13,22,2,37
Gammarus pisinnus,15907,13,22,2,37
Longpotamon kenliense,18499,13,22,2,37
Daphnia similis,15132,13,22,2,37
Corythucha marmorata,15635,13,22,2,37
Parribacus antarcticus,15806,13,22,2,37
Scyllarides squammosus,15644,13,22,2,37
Aphyosemion kunzi,17154,13,22,2,37
Scriptaphyosemion guignardi,16459,13,22,2,37
Aphyosemion coeleste,16513,13,22,2,37
Scriptaphyosemion bertholdi,16467,13,22,2,37
Fundulopanchax amieti,16492,13,22,2,37
Aplocheilus lineatus,16554,13,22,2,37
Epiplatys togolensis,16558,13,22,2,37
Epiplatys multifasciatus,16523,13,22,2,37
Fundulopanchax scheeli,16455,13,22,2,37
Scriptaphyosemion schmitti,16468,13,22,2,37
Nothobranchius vosseleri,18585,13,22,2,37
Epiplatys guineensis,16632,13,22,2,37
Epiplatys lamottei,16523,13,22,2,37
Aphyosemion cognatum,16539,13,22,2,37
Fundulopanchax gardneri,16722,13,22,2,37
Aphyosemion kouamense,16519,13,22,2,37
Fundulopanchax sjostedti,16541,13,22,2,37
Nothobranchius kuhntae,19801,13,22,2,37
Epiplatys spilargyreius,16522,13,22,2,37
Nimbapanchax petersi,16472,13,22,2,37
Nothobranchius ocellatus,16937,13,22,2,37
Pronothobranchius seymouri,17014,13,22,2,37
Fundulopanchax filamentosus,17554,13,22,2,37
Aphyosemion australe,16597,13,22,2,37
Aphyosemion gabunense,16502,13,22,2,37
Archiaphyosemion guineense,16511,13,22,2,37
Aphyosemion cyanostictum,16518,13,22,2,37
Nimbapanchax leucopterygius,16510,13,22,2,37
Epiplatys grahami,16548,13,22,2,37
Nothobranchius kafuensis,17536,13,22,2,37
Scriptaphyosemion cauveti,16483,13,22,2,37
Nothobranchius thierryi,17206,13,22,2,37
Nothobranchius foerschi,17227,13,23,2,38
Aphyosemion cameronense,16522,13,22,2,37
Gammarus lacustris,15333,13,22,2,37
Sardinella fijiensis,16651,13,22,2,37
Pyxicephalus adspersus,24317,15,29,4,48
Limonia phragmitidis,15924,13,22,2,37
Chaetodontoplus poliourus,16961,13,22,2,37
Miniopterus fuliginosus,16961,13,22,2,37
Psettina iijimae,18080,13,22,2,37
Arnoglossus tenuis,17556,13,22,2,37
Echinococcus granulosus,17675,12,22,2,36
Trichopodus pectoralis,16397,13,22,2,37
Ceratocystis fimbriata,103403,52,31,2,85
Volvariella volvacea,65668,32,26,2,60
Beroe forskalii,13338,13,0,2,15
Pseudoregma bambucicola,16632,13,22,2,37
Geoemyda spengleri,17448,13,22,2,37
Postharmostomum commutatum,13799,12,22,2,36
Lepidurus apus lubbocki,15635,13,22,2,37
Tringa totanus,16818,13,22,2,37
Leuresthes tenuis,16719,13,22,2,37
Decapterus tabl,16545,13,22,2,37
Tringa nebularia,16682,13,22,2,37
Paratrichobius longicrus,16296,13,22,2,37
Neoscona multiplicans,14074,13,22,2,37
Lepidurus arcticus,15223,13,22,2,37
Coquillettidia chrysonotum,15389,13,22,2,37
Limatus flavisetosus,15663,13,22,2,37
Mansonia amazonensis,15357,13,22,2,37
Psorophora saeva,15049,13,22,2,37
Runchomyia reversa,15302,13,22,2,37
Sabethes undosus,15334,13,22,2,37
Trichoprosopon pallidiventer,16037,13,22,2,37
Uranotaenia geometrica,15593,13,22,2,37
Wyeomyia confusa,15426,13,22,2,37
Anindobothrium anacolum,13693,12,22,2,36
Drosophila mercatorum,16024,13,22,2,37
Caracara plancus,17077,13,22,2,37
Caracara cheriway,17077,13,22,2,37
Caracara creightoni,16931,13,22,2,37
Argiope perforata,14032,13,22,2,37
Cyclosa japonica,14687,13,22,2,37
Blepephaeus succinctor,15554,13,22,2,37
Nortia carinicollis,15602,13,22,2,37
Pterolophia sp. ZJY-2019,16063,13,22,2,37
Thermistis croceocincta,15503,13,22,2,37
Paradyschiria parvula,14588,13,22,2,37
Rhinebothrium reydai,13506,12,22,2,36
Hypsauchenia hardwickii,15618,13,22,2,37
Maurya qinlingensis,16011,13,22,2,37
Leptocentrus albolineatus,15508,13,22,2,37
Tricentrus brunneus,16467,13,22,2,37
Limnephilus hyalinus,15168,13,22,2,37
Anthonomus eugenii,17257,13,22,2,37
Anthonomus pomorum,17093,13,22,2,37
Anthonomus rectirostris,17676,13,22,2,37
Anthonomus rubi,17476,13,22,2,37
Luciogobius grandis,16477,13,22,2,37
Luciogobius elongatus,16486,13,22,2,37
Pseudotolithus elongatus,16497,13,22,2,37
Mesonemoura metafiligera,15739,13,22,2,37
Mesonemoura tritaenia,15778,13,22,2,37
Rhagovelia reitteri,15145,13,22,2,37
Limnogonus hypoleucus,15325,13,22,2,37
Limnogonus poissoni,15320,13,22,2,37
Limnogonus intermedius,15333,13,22,2,37
Asterorhombus intermedius,16886,13,22,2,37
Bittacus strigosus,15825,13,22,2,37
Panorpa debilis,17018,13,22,2,37
Polyplectron malacense,16691,13,22,2,37
Antheraea pernyi x Antherea roylei,15573,13,22,2,37
Hemiscyllium ocellatum,16728,13,22,2,37
Amphinemura longispina,15709,13,22,2,37
Amphinemura yao,15876,13,22,2,37
Indonemoura jacobsoni,15642,13,22,2,37
Indonemoura nohirae,15738,13,22,2,37
Protonemura kohnoae,15707,13,22,2,37
Protonemura orbiculata,15758,13,22,2,37
Sphaeronemoura grandicauda,15661,13,22,2,37
Sphaeronemoura hamistyla,15016,13,22,2,37
Dytiscus sharpi,19476,13,22,2,37
Carabus granulatus,16918,13,22,2,37
Pterostichus niger,17162,13,22,2,37
Eurydema dominulus,16752,13,22,2,37
Eurydema liturifera,15585,13,22,2,37
Eurydema oleracea,15892,13,22,2,37
Eurydema qinlingensis,15820,13,22,2,37
Lepus arcticus,17109,13,22,2,37
Thitarodes damxungensis,15362,13,22,2,37
Pristolepis rubripinnis,16622,13,22,2,37
Abscondita terminalis,16402,13,22,2,37
Emeia pseudosauteri,16327,13,22,2,37
Triops granarius,15121,13,22,2,37
Anarrhichthys ocellatus,16506,13,22,2,37
Alicella gigantea,16851,13,22,2,37
Ryssota otaheitana,13888,13,22,2,37
Lamprigera yunnana,16203,13,22,2,37
Diaphanes nubilus,17683,13,22,2,37
Vesta saturnalis,16932,13,22,2,37
Curtos bilineatus,16677,13,22,2,37
Pyrocoelia praetexta,17634,13,22,2,37
Diaphanes mendax,17959,13,22,2,37
Pyrocoelia thibetana,18054,13,22,2,37
Diaphanes pectinealis,17981,13,22,2,37
Halicampus grayi,17059,13,22,2,37
Leptaulax koreanus,18730,13,22,2,37
Dermestes tessellatocollis,16218,13,22,2,37
Dermestes frischii,15873,13,22,2,37
Dermestes coarctatus,15873,13,22,2,37
Equus burchellii quagga,16606,13,22,2,37
Ophiura sarsii,16603,13,22,2,37
Xenopus calcaratus,17523,13,22,2,37
Xenopus mellotropicalis,17700,13,22,2,37
Xenopus epitropicalis,17808,13,22,2,37
Xenopus largeni,17186,13,22,2,37
Xenopus petersii,17729,13,22,2,37
Xenopus poweri,17581,13,22,2,37
Xenopus gilli,16923,13,22,2,37
Xenopus parafraseri,16708,13,22,2,37
Xenopus pygmaeus,17189,13,22,2,37
Xenopus allofraseri,17498,13,22,2,37
Xenopus wittei,17715,13,22,2,37
Xenopus amieti,16976,13,22,2,37
Xenopus boumbaensis,16807,13,22,2,37
Xenopus andrei,17443,13,22,2,37
Xenopus itombwensis,16853,13,22,2,37
Xenopus lenduensis,17152,13,22,2,37
Xenopus vestitus,16779,13,22,2,37
Xenopus ruwenzoriensis,16645,13,22,2,37
Xenopus kobeli,17811,13,22,2,37
Xenopus eysoole,17397,13,22,2,37
Xenopus longipes,17196,13,22,2,37
Xenopus clivii,16794,13,22,2,37
Xenopus muelleri,17478,13,22,2,37
Xenopus fischbergi,17189,13,22,2,37
Idgia oculata,15805,13,22,2,37
Cociella crocodilus,17305,13,22,2,37
Iguana delicatissima,16615,13,22,2,37
Amolops granulosus,17785,13,22,2,37
Actinia tenebrosa,20691,13,2,2,17
Bootherium bombifrons,16426,13,22,2,37
Lucanus fortunei,16591,13,22,2,37
Prismognathus prossi,15984,13,22,2,37
Rhinogobius leavelli,16499,13,22,2,37
Macrovipera schweizeri,17152,13,22,2,37
Xerotyphlops vermicularis,16568,13,22,2,37
Oligosarcus argenteus,16711,13,22,2,37
Deuterodon giton,16643,13,22,2,37
Monachus monachus,16739,13,22,2,37
Archivesica marissinica,17374,13,22,2,37
Steinernema abbasi,13924,12,22,2,36
Spondias mombin,674158,34,28,3,65
Tamarindus indica,607282,37,24,4,65
Libidibia coriaria,601574,39,22,3,64
Haematoxylum brasiletto,631094,42,24,4,70
Prototheca bovis,39222,34,26,3,63
Ilex pubescens,517520,34,17,3,54
Phytophthora sansomeana,39618,42,25,2,69
Diphylla ecaudata,16618,13,22,2,37
Spondias tuberosa,779106,35,37,4,76
Pagurus nigrofascia,15423,13,23,2,38
Phaseolus vulgaris,395516,31,18,3,52
Manihot esculenta,682840,32,17,3,52
Paulinella micropora,37152,28,22,0,50
Garra tibetana,16861,13,22,2,37
Hippocampus hippocampus,16529,13,22,2,37
Cynoglossus senegalensis,16519,13,22,2,37
Aquila nipalensis,18450,13,22,2,37
Rousettus amplexicaudatus,16509,13,22,2,37
Linepithema humile,15929,13,22,2,37
Rucervus duvaucelii branderi,16407,13,22,2,37
Conocephalus maculatus,15905,13,22,2,37
Discocheilus wui,16589,13,22,2,37
Discolabeo wuluoheensis,16587,13,22,2,37
Cyclommatus strigiceps vitalisi,17853,13,22,2,37
Semnoderes armiger,14986,12,22,2,36
Sicyopterus japonicus,16504,13,22,2,37
Aphaena amabilis,16237,13,22,2,37
Ara macao,16970,13,22,2,37
Palaemon sinensis,15955,13,22,2,37
Grammatobothus polyophthalmus,18170,13,22,2,37
Harpalus sinicus,16521,13,22,2,37
Pseudocleopatra dartevellei,15368,13,22,2,37
Xystrocera globosa,15707,13,22,2,37
Ceutorhynchus obstrictus,20124,13,22,2,37
Figulus binodulus,16261,13,22,2,37
Paracolopha morrisoni,16330,13,22,2,37
Microhyla fissipes,16723,13,22,2,37
Sinna extrema,15345,13,22,2,37
Velutinodorcus velutinus,14748,13,22,2,37
Dorcus ursulus,18220,13,22,2,37
Dorcus tenuihirsutus,18505,13,22,2,37
Coleochaete scutata,242024,80,30,5,115
Ceratocystis albifundus,102548,52,30,2,84
Amanita pseudoporphyria,52733,22,25,2,49
Amanita basii,37341,16,25,2,43
Amanita bisporigera,76761,26,27,2,55
Amanita brunnescens,62533,23,28,2,53
Amanita inopinata,59691,21,26,2,49
Amanita muscaria,62233,33,27,2,62
Amanita phalloides,101106,49,27,2,78
Amanita thiersii,137428,43,28,2,73
Macrolepiota fuliginosa,59025,26,24,2,52
Paxillus involutus,39109,19,25,2,46
Paxillus rubicundulus,41061,17,25,2,44
Turbinellus floccosus,62846,16,24,2,42
Rhaphiolepis bibas,434980,41,23,3,67
Russula griseocarnosa,60995,12,3,1,16
Microsporum canis CBS 113480,21449,0,0,0,0
Blastomyces gilchristii SLH14081,7187,0,0,0,0
Blastomyces gilchristii SLH14081,8933,0,0,0,0
Blastomyces gilchristii SLH14081,34670,0,0,0,0
Bombus terrestris lusitanicus,17049,13,22,2,37
Bombus terrestris terrestris,17232,13,22,2,37
Muscicapa griseisticta,17897,13,22,2,37
Ampithoe lacertosa,14607,13,22,2,37
Hypostomus francisci,16541,13,22,2,37
Baltia butleri,15124,13,22,2,37
Pieris naganum,15155,13,22,2,37
Pontia callidice,15109,13,22,2,37
Pontia daplidice,15124,13,22,2,37
Capricornis rubidus,16524,13,22,2,37
Eleginus gracilis,16538,13,22,2,37
Olidiana ritcheriina,15166,13,22,2,37
Hynobius unisacculus,16413,13,22,2,37
Acosmetura nigrogeniculata,16271,13,22,2,37
Creteuchiloglanis kamengensis,16589,13,22,2,37
Glyptothorax annandalei,16541,13,22,2,37
Vespula flaviceps,17489,13,22,2,37
Bipalium kewense,15666,12,22,2,36
Murexia melanurus,17736,13,22,2,37
Lepidotrigla kanagashira,16504,13,22,2,37
Lactarius lactarius,16552,13,22,2,37
Arius maculatus,16710,13,22,2,37
Lebbeus groenlandicus,17399,13,22,2,37
Microphysogobio jeoni,16820,13,22,2,37
Iksookimia yongdokensis,16640,13,22,2,37
Coregonus baicalensis,16735,13,22,2,37
Coregonus migratorius,16737,13,22,2,37
Russula subnigricans,60949,33,25,2,60
Ostreobium quekettii,241739,54,28,3,85
Chlorella vulgaris,87477,35,27,3,65
Scherffelia dubia,78958,34,29,6,69
Morchella importuna,272238,158,31,2,191
Nothobranchius nubaensis,19116,13,23,2,38
Reticulitermes tibialis,14990,13,22,0,35
Plestiodon tunganus,17263,13,22,2,37
Aphis glycines,17954,13,22,2,37
Euchorthippus unicolor,15629,13,22,2,37
Abrus expansivus,15904,13,22,2,37
Dasypogon diadema,16947,13,22,2,37
Reticulitermes lucifugus,16263,13,22,0,35
Daphnia laevis,15246,13,22,2,37
Cottiusculus nihonkaiensis,16612,13,22,2,37
Epicauta impressicornis,15713,13,22,2,37
Gastrophysa polygoni,17277,13,22,2,37
Epicopeia hainesii,15395,13,22,2,37
Hasora badra,15324,13,22,2,37
Microphysogobio rapidus,16603,13,22,2,37
Pseudeuphausia sinica,16192,13,22,2,37
Paramacrosteles nigromaculatus,15011,13,22,2,37
Sterna paradisaea,16708,13,22,2,37
Bombus waltoni,19349,13,22,2,37
Cryodraco antarcticus,17857,13,22,2,37
Beroe cucumis,10487,10,0,2,12
Vulcanolepas fijiensis,17374,13,22,2,37
Accipiter trivirgatus,18454,13,22,2,37
Dromaius baudinianus,16713,13,22,2,37
Saltator similis,16750,13,22,2,37
Agapornis nigrigenis,16718,13,22,2,37
Agapornis pullarius,16722,13,22,2,37
Agapornis lilianae,16720,13,22,2,37
Rupicola peruvianus,17035,13,22,2,37
Aratinga nenday,16983,13,22,2,37
Picus canus,17103,13,22,2,37
Mareca strepera,16600,13,22,2,37
Muscicapa sibirica,17879,13,22,2,37
Muscicapa latirostris,18026,13,22,2,37
Dendrocitta formosae,16875,13,22,2,37
Aptenodytes patagonicus,17477,13,22,2,37
Psittacula alexandri,16883,13,22,2,37
Psittacula roseata,16814,13,22,2,37
Corvus pectoralis,16857,13,22,2,37
Stichaeus grigorjewi,16532,13,22,2,37
Siva cyanouroptera,17862,13,22,2,37
Fulvetta ruficapilla,16941,13,22,2,37
Sousa teuszii,16384,13,22,2,37
Megopis sinica,15689,13,22,2,37
Sphenomorphus indicus,17027,13,22,2,37
Athalia proxima,15852,13,22,2,37
Verticillium dahliae VdLs.17,9712,0,0,0,0
Verticillium dahliae VdLs.17,19770,0,0,0,0
Verticillium dahliae VdLs.17,42389,0,0,0,0
Aethia cristatella,16848,13,22,2,37
Lycodes reticulatus,16590,13,22,2,37
Lycenchelys muraena,16874,12,25,2,39
Stigmatogobius pleurostigma,16494,13,22,2,37
Phylloscopus tenellipes,16904,13,22,2,37
Phylloscopus borealis,16881,13,22,2,37
Rotunda rotundapex,15298,13,22,2,37
Aculamprotula scripta,15688,13,22,2,37
Drosophila subobscura,15878,13,22,2,37
Sydowia polyspora,37422,15,26,2,43
Leucocryptos marina,67380,55,27,2,84
Plasmopara viticola,42644,44,27,2,73
Caulerpa ashmeadii,197427,22,16,2,40
Epirixanthes elongata,365168,34,13,5,52
Jaagichlorella roystonensis,130507,64,34,2,100
Monolepta occifluvis,15998,13,22,2,37
Homoeoxipha nigripes,15679,13,22,2,37
Dianemobius fascipes,15363,13,22,2,37
Dianemobius furumagiensis,15350,13,22,2,37
Polionemobius taprobanensis,16641,13,22,2,37
Aenasius arizonensis,15373,13,22,2,37
Holothuria pervicax,15790,13,22,2,37
Batrachuperus sp. 2 PZ-2020,16394,13,22,2,37
Batracomorphus lateprocessus,15356,13,22,2,37
Hormiphora californensis,12564,14,0,2,16
Cryptotermes declivis,15678,13,22,2,37
Macridiscus melanaegis,20738,12,22,2,36
Lycodes brevipes,16537,13,22,2,37
Diamesus osculans,19400,13,22,2,37
Myoxocephalus jaok,16653,13,22,2,37
Psychomantis borneensis,15493,13,22,2,37
Sturisomatichthys panamensis,16497,13,22,2,37
Cephenemyia trompe,16387,13,22,2,37
Rhinoestrus usbekistanicus,16534,13,22,2,37
Oxya agavisa,15552,13,22,2,37
Notonecta montandoni,15150,13,22,2,37
Macridiscus multifarius,20171,12,22,2,36
Platypus contaminatus,15712,13,22,2,37
Euproctis seitzi,15276,13,22,2,37
Indomegoura indica,15220,13,22,2,37
Actias luna,15259,13,22,2,37
Suricata suricatta,16914,13,22,2,37
Phyllotreta striolata,15689,13,22,2,37
Macroxyela ferruginea,15465,13,22,2,37
Asobara japonica,15519,13,22,2,37
Eospalax fontanierii,16369,13,22,2,37
Fusinus longicaudus,16319,13,22,2,37
Semilabeo notabilis,16599,13,22,2,37
Dryophytes versicolor,18800,13,22,2,37
Discogobio laticeps,16596,13,22,2,37
Opisthocentrus ocellatus,16517,13,22,2,37
Copris tripartitus,15457,13,22,2,37
Leptalina unicolor,15854,13,22,2,37
Gymnocanthus tricuspis,16570,13,22,2,37
Oxya hainanensis,15443,13,22,2,37
Argopistes tsekooni,16552,13,22,2,37
Tagasta indica,15531,13,22,2,37
Goniopora djiboutiensis,18765,13,2,2,17
Sineleotris chalmersi,16485,13,22,2,37
Schizopygopsis kessleri,16767,13,22,2,37
Trichoplusia ni,15239,13,22,2,37
Ophiomastix mixta,16495,13,22,2,37
Amphiura sinicola,15348,13,22,2,37
Ophiopholis japonica,16214,13,22,2,37
Ophiopholis mirabilis,16398,13,22,2,37
Sinocrossocheilus liuchengensis,16600,13,22,2,37
Stephanometra indica,15878,13,22,2,37
Darevskia armeniaca,17521,13,22,2,37
Darevskia dahli,17528,13,22,2,37
Darevskia mixta,17532,13,22,2,37
Darevskia parvula,17510,13,22,2,37
Darevskia portschinskii,17529,13,22,2,37
Darevskia rudis,17534,13,22,2,37
Darevskia saxicola,17524,13,22,2,37
Rhizoprionodon acutus,16693,13,22,2,37
Vespa simillima simillima,18340,13,22,2,37
Rhinolophus pusillus,16833,13,22,2,37
Barilius malabaricus,16519,13,22,2,37
Pogonophryne albipinna,17086,13,22,2,37
Macrocheles glaber,14753,13,21,2,36
Macrocheles muscaedomesticae,14526,13,22,2,37
Blattisocius tarsalis,16454,13,22,2,37
Hypoaspis linteyini,14529,13,22,2,37
Corvus dauuricus,16921,13,22,2,37
Neoplerochila paliatseasi,15348,13,22,2,37
Gonimbrasia belina,15308,13,22,2,37
Gynanisa maja,15275,13,22,2,37
Anchistus australis,15396,13,21,2,36
Carpophilus pilosellus,15686,13,22,2,37
Carpophilus dimidiatus,15717,13,22,2,37
Limassolla lingchuanensis,15716,13,22,2,37
Arion vulgaris,14548,13,22,2,37
Trachys auricollis,16429,13,22,2,37
Lycodon ruhstrati,17168,13,22,2,37
Bufotes pseudoraddei,17189,13,22,2,37
Idiocerus salicis,16436,13,23,2,38
Anarta trifolii,15281,13,22,2,37
Pyrausta despicata,15389,13,22,2,37
Celypha flavipalpana,15498,13,22,2,37
Ocinebrellus falcatus,15326,13,22,2,37
Ophiarachnella gorgonia,15948,13,22,2,37
Bos grunniens x Bos taurus,16322,13,22,2,37
Diaphorencyrtus aligarhensis,16264,13,22,2,37
Iassus dorsalis,15176,13,22,2,37
Krisna concava,14304,13,22,2,37
Krisna rufimarginata,14724,13,22,2,37
Debaryomyces fabryi,712,0,0,0,0
Debaryomyces fabryi,579,0,0,0,0
Nitella hyalina,80193,48,27,3,78
Colletotrichum lupini,36554,15,29,2,46
Gangesia oligonchis,13958,12,22,2,36
Zhangixalus omeimontis,19604,13,22,2,37
Acropyga sauteri,16976,13,22,2,37
Acropyga smithii,15558,13,22,2,37
Hydrozoanthus gracilis,20689,13,1,2,16
Nanozoanthus harenaceus,18577,13,1,2,16
Palythoa mizigama,21104,13,1,2,16
Liparis tessellatus,17221,13,22,2,37
Sphaerothecum destruens,23939,23,22,2,47
Corbicula fluminea,17423,13,22,2,37
Gesonula punctifrons,15432,13,22,2,37
Tetrix ruyuanensis,15218,13,22,2,37
Curruca curruca,17959,13,22,2,37
Acrocephalus orientalis,17960,13,22,2,37
Alaudala cheleensis,17021,13,22,2,37
Acropyga panamensis,16633,13,22,2,37
Pseudogastromyzon changtingensis changtingensis,16571,13,22,2,37
Pseudogastromyzon cheni,16567,13,22,2,37
Pseudogastromyzon fasciatus fasciatus,16561,13,22,2,37
Pseudogastromyzon laticeps,16561,13,22,2,37
Pseudogastromyzon lianjiangensis,16568,13,22,2,37
Pseudogastromyzon meihuashanensis,16561,13,22,2,37
Pseudogastromyzon peristictus,16566,13,22,2,37
Amesia sanguiflua,15203,13,22,2,37
Mellicta ambigua,15205,13,22,2,37
Hemitripterus villosus,17228,13,22,2,37
Zoanthus sociatus,21202,13,1,2,16
Ctenolepisma villosa,15488,13,22,2,37
Plumarella adhaerans,19036,14,1,2,17
Hippodamia variegata,17823,13,22,2,37
Aonyx capensis,16188,13,22,2,37
Hydrictis maculicollis,16308,13,22,2,37
Koreoleptoxis nodifila,15737,13,22,2,37
Palmaria decipiens,26645,24,23,2,49
Tricholoma terreum,80705,32,27,2,61
Tricholoma flavovirens,49480,21,26,2,49
Boreotrophon candelabrum,15265,13,22,2,37
Holothuria spinifera,15812,12,22,2,36
Stygobromus pizzinii,15176,13,22,2,37
Stygobromus allegheniensis,15164,13,22,2,37
Limecola balthica,17492,13,22,2,37
Salina celebensis,14788,13,22,2,37
Ceratophysella communis,15331,13,22,2,37
Lacanobia aliena,15400,13,22,2,37
Ceratostoma rorifluum,15338,13,23,2,38
Conophymacris viridis,15654,13,22,2,37
Indopodisma kingdoni,15627,13,22,2,37
Paratonkinacris vittifemoralis,15625,13,22,2,37
Spathosternum prasiniferum prasiniferum,15596,13,22,2,37
Xiangelilacris zhongdianensis,15507,13,22,2,37
Pseudoeoscyllina brevipennisoides,15629,13,22,2,37
Bryodema nigroptera,15933,13,22,2,37
Bryodemella holdereri holdereri,15929,13,22,2,37
Oedaleus abruptus,16251,13,22,2,37
Parapleurus alliaceus,16252,13,22,2,37
Ergatettix dorsifera,15326,13,22,2,37
Sinopodisma funiushana,15894,13,22,2,37
Sinopodisma wudangshanensis,15834,13,22,2,37
Ruidocollaris convexipennis,16437,13,22,2,37
Sinopodisma lushiensis,15869,13,22,2,37
Sphingonotus menglaensis,15948,13,22,2,37
Traulia lofaoshana,15644,13,22,2,37
Atractomorpha psittacina,15567,13,22,2,37
Bryodemacris uvarovi,15929,13,22,2,37
Bryodemella tuberculata diluta,15927,13,22,2,37
Emeiacris maculata,15570,13,22,2,37
Filchnerella qilianshanensis,15661,13,22,2,37
Filchnerella tenggerensis,15659,13,22,2,37
Pedopodisma emeiensis,15902,13,22,2,37
Sinopodisma lofaoshana,15867,13,22,2,37
Sphingonotus ningsianus,16261,13,22,2,37
Sphingonotus yenchihensis,16261,13,22,2,37
Traulia orchotibialis,15642,13,22,2,37
Ceratostoma burnetti,15334,13,22,2,37
Oxytauchira brachyptera,15445,13,22,2,37
Istigobius campbelli,16527,13,22,2,37
Ocinebrellus inornatus,15324,13,23,2,38
Thaumatosmylus hainanus,16029,13,22,2,37
Cylas formicarius,17150,13,22,2,37
Minous monodactylus,16459,13,22,2,37
Angiostrongylus mackerrasae,13356,12,22,2,36
Scolytus seulensis,16396,13,22,2,37
Euspira gilva,15315,13,22,2,37
Mammilla mammata,15319,13,22,2,37
Cryptonatica andoi,15302,13,22,2,37
Caloptilia theivora,15297,13,22,2,37
Echinostoma revolutum,15714,12,22,2,36
Microzoanthus occultus,21656,13,1,2,16
Palythoa mutuki,21278,13,1,2,16
Parazoanthus elongatus,21148,13,1,2,16
Sphenopus marsupialis,21199,13,1,2,16
Phylloscopus fuscatus,16922,13,22,2,37
Acropyga goeldii,15673,13,22,2,37
Acropyga fuhrmanni,15568,13,22,2,37
Acropyga guianensis,16011,13,22,2,37
Acropyga kinomurai,18287,13,22,2,37
Acropyga myops,16659,13,22,2,37
Acropyga pallida,16886,13,22,2,37
Pseudogastromyzon changtingensis tungpeiensis,16574,13,22,2,37
Pseudogastromyzon fangi,16572,13,22,2,37
Pseudogastromyzon fasciatus jiulongjiangensis,16560,13,22,2,37
Schizothorax griseus,16586,13,22,2,37
Plumarella spinosa,19037,14,1,2,17
Ammopiptanthus nanus,339352,35,18,3,56
Dacus bivittatus,15833,13,22,2,37
Carabus changeonleei,16831,13,22,2,37
Epizoanthus illoricatus,20447,13,1,2,16
Parazoanthus swiftii,21499,13,1,2,16
Cephalopina titillator,16461,13,22,2,37
Coenonympha amaryllis,15125,13,22,2,37
Ailia coila,16497,13,22,2,37
Tricholoma bakamatsutake,103090,46,19,2,67
Tricholoma saponaceum,94261,50,29,2,81
Orthaga olivacea,15174,13,22,2,37
Bactrurus brachycaudus,14661,13,22,2,37
Bactrocera rubigina,15285,13,22,2,37
Athetis pallidipennis,15344,13,22,2,37
Apalacris nigrogeniculata,15584,13,22,2,37
Shirakiacris yunkweiensis,15655,13,22,2,37
Heteropternis respondens,16265,13,22,2,37
Euparatettix bimaculatus,15221,13,22,2,37
Euparatettix variabilis,15194,13,22,2,37
Bryodema dolichoptera,15924,13,22,2,37
Calliptamus barbarus,15578,13,22,2,37
Fruhstorferiola omei,15639,13,22,2,37
Dericorys annulata,15463,13,22,2,37
Euthystira luteifemora,15608,13,22,2,37
Omocestus viridulus,15635,13,22,2,37
Fusarium pseudograminearum,110525,65,28,2,95
Fusarium cerealis,93160,52,28,2,82
Opisina arenosella,15389,13,22,2,37
Scolytus schevyrewi,15891,13,22,2,37
Pangasius bocourti,16522,13,22,2,37
Minois dryas,15195,13,22,2,37
Zemeros flegyas,15219,13,22,2,37
Neverita didyma,15629,13,22,2,37
Polinices sagamiensis,15383,13,22,2,37
Mammilla kurodai,15309,13,22,2,37
Drosophila pseudoobscura,16118,13,22,2,37
Xylaria hypoxylon,129366,19,27,2,48
Salix paraflabellaris,637893,29,22,3,54
Andreaea wangiana,117857,40,24,3,67
Pohlia nutans,99864,38,24,3,65
Jenufa perforata,27198,13,25,6,44
Jenufa minuta,41488,15,24,6,45
Tolypocladium cylindrosporum,34698,24,26,2,52
Akanthomyces lecanii,24643,15,26,2,43
Roya anglica,69371,42,23,3,68
Gonatozygon brebissonii,131939,45,26,3,74
Bipolaris sorokiniana,137775,63,38,3,104
Metarhizium rileyi,62514,42,25,2,69
Caulacanthus okamurae,25995,25,23,2,50
Penicillium citrinum,27537,16,24,2,42
Bartramia patens,106827,40,24,3,67
Artemia sinica,15689,13,22,2,37
Dipturus batis,16911,13,22,2,37
Rattus andamanensis,16304,13,22,2,37
Streptocephalus cafer,17020,13,22,2,37
Cryptalaus yamato,15882,13,22,2,37
Dipsastraea favus,17054,13,2,2,17
Aurelia limbata,16953,13,2,2,17
Eurytemora affinis,18573,13,22,2,37
Tituria pyramidata,15331,13,22,2,37
Euspira pila,15244,13,22,2,37
Cryptonatica janthostoma,15235,13,22,2,37
Notocochlis gualtieriana,15176,13,22,2,37
Salvelinus boganidae,16655,13,22,2,37
Salvelinus elgyticus,16654,13,22,2,37
Salvelinus levanidovi,16624,13,22,2,37
Salvethymus svetovidovi,16655,13,22,2,37
Salvelinus taranetzi,16654,13,22,2,37
Cylicocyclus ashworthi,13876,12,22,2,36
Parallelia stuposa,15721,13,22,2,37
Adhemarius dentoni,15423,13,22,2,37
Ambulyx dohertyi,15304,13,22,2,37
Ambulyx substrigilis,15333,13,22,2,37
Amplypterus mansoni,15394,13,22,2,37
Amplypterus panopus,15370,13,22,2,37
Barbourion lemaii,15366,13,22,2,37
Batocnema coquerelii,15361,13,22,2,37
Clanis bilineata,15426,13,22,2,37
Leucophlebia lineata,15454,13,22,2,37
Orecta lycidas,15387,13,22,2,37
Protambulyx astygonus,15345,13,22,2,37
Protambulyx eurycles,15542,13,22,2,37
Protambulyx ockendeni,15395,13,22,2,37
Protambulyx strigilis,15534,13,22,2,37
Trogolegnum pseudambulyx,15387,13,22,2,37
Adhemarius dariensis,15676,13,22,2,37
Aporrectodea rosea,15086,13,22,2,37
Cynoglossus roulei,16598,13,22,2,37
Oxyopes hupingensis,15078,13,22,2,37
Rhopalosiphum nymphaeae,15594,13,22,2,37
Neotermes koshunensis,15589,13,22,2,37
Phyllodiaptomus tunguidus,16446,13,22,2,37
Etheostoma trisella,16572,13,22,2,37
Clarias macrocephalus,16511,13,22,2,37
Callionymus olidus,16491,13,22,2,37
Homatula laxiclathra,16570,13,22,2,37
Epophthalmia elegans,15719,13,22,2,37
Tetraonchus monenteron,14791,12,22,2,36
Chionobathyscus dewitti,17452,13,22,2,37
Lepidotrigla hime,16606,13,22,2,37
Calidris tenuirostris,16732,13,22,2,37
Limosa lapponica,16773,13,22,2,37
Sciara ruficauda,15167,13,22,2,37
Dolichosciara megumiae,15931,13,23,2,38
Trichosia lengersdorfi,16171,13,22,2,37
Chrysaora pacifica,16964,13,2,2,17
Aphrodita australis,15288,13,22,2,37
Aurelia coerulea,16748,13,2,2,17
Hydrophis curtus,17702,13,22,2,37
Hydrophis cyanocinctus,17750,13,22,2,37
Ocypode stimpsoni,15557,13,22,2,37
Opisthotropis latouchii,17051,13,22,2,37
Sinolapotamon patellifer,16547,13,22,2,37
Crocidura tanakae,16969,13,22,2,37
Eudarcia gwangneungensis,15391,13,22,2,37
Enoplops potanini,17101,13,22,2,37
Tanacetipathes thamnea,17712,13,2,2,17
Holothuria leucospilota,15904,13,22,2,37
Stichaeus nozawae,16530,13,22,2,37
Annamanum lunulatum,15610,13,22,2,37
Calidris pugnax,16902,13,22,2,37
Oncopodura yosiiana,14808,13,22,2,37
Dicranocentrus wangi,14883,13,22,2,37
Cyphoderus albinus,14836,13,22,2,37
Oeneis urda,15248,13,22,2,37
Cheirotonus gestroi,16899,13,22,2,37
Anterastes babadaghi,15883,13,22,2,37
Myrmus lateralis,17309,13,22,2,37
Casinycteris argynnis,16661,13,22,2,37
Casinycteris campomaanensis,16630,13,22,2,37
Casinycteris ophiodon,16477,13,22,2,37
Cynopterus sphinx,16897,13,22,2,37
Eidolon helvum,16764,13,22,2,37
Eonycteris spelaea,16700,13,22,2,37
Epomophorus crypturus,16733,13,22,2,37
Epomophorus labiatus,16741,13,22,2,37
Epomophorus wahlbergi,16668,13,22,2,37
Epomophorus minimus,16743,13,22,2,37
Epomophorus minor,16849,13,22,2,37
Epomops buettikoferi,16867,13,22,2,37
Epomops dobsonii,16543,13,22,2,37
Epomops franqueti,16686,13,22,2,37
Hypsignathus monstrosus,16738,13,22,2,37
Macroglossus sobrinus,16415,13,22,2,37
Megaerops niphanae,16604,13,22,2,37
Megaloglossus azagnyi,16538,13,22,2,37
Megaloglossus woermanni,16632,13,22,2,37
Micropteropus pusillus,16727,13,22,2,37
Lissonycteris angolensis,16566,13,22,2,37
Myonycteris leptodon,16493,13,22,2,37
Myonycteris relicta,16715,13,22,2,37
Myonycteris torquata,16728,13,22,2,37
Nanonycteris veldkampii,16699,13,22,2,37
Nyctimene cephalotes,16702,13,22,2,37
Plerotes anchietae,16799,13,22,2,37
Pteropus ornatus,16718,13,22,2,37
Rousettus leschenaultii,16655,13,22,2,37
Rousettus madagascariensis,16777,13,22,2,37
Rousettus obliviosus,16636,13,22,2,37
Scotonycteris bergmansi,16727,13,22,2,37
Scotonycteris zenkeri occidentalis,16666,13,22,2,37
Scotonycteris zenkeri,16731,13,22,2,37
Sphaerias blanfordi,16776,13,22,2,37
Rousettus lanosus,16801,13,22,2,37
Lepidozona coreanica,16572,13,22,2,37
Girella melanichthys,16518,13,22,2,37
Hercostomus brevipilosus,15019,13,22,2,37
Paradoxornis heudei,16924,12,22,2,36
Sarcocheilichthys variegatus wakiyae,16675,13,22,2,37
Aedes koreicus,15840,13,22,2,37
Turdus cardis,16761,13,22,2,37
Cavia aperea,16681,13,22,2,37
Bactrocera ruiliensis,15870,13,22,2,37
Harpalus pensylvanicus,16434,13,22,2,37
Tephritis femoralis,15117,13,22,2,37
Capsala pricei,13851,12,22,2,36
Notacanthus bonaparte,16623,13,22,2,37
Batillaria attramentaria,16095,13,22,2,37
Peromyscus eremicus,15988,13,22,2,37
Lepidocyrtus fimetarius,14698,13,22,2,37
Calappa bilineata,15606,13,22,2,37
Ovis ammon ammon,16612,13,22,2,37
Bruchidius uberatus,15892,13,22,2,37
Ara chloropterus,16991,13,22,2,37
Megalobrama terminalis x Culter alburnus,16621,13,22,2,37
Chiromantes eulimene,15894,13,22,2,37
Paraleucogobio notacanthus,16596,13,22,2,37
Erannis ankeraria,15250,13,22,2,37
Epiactis japonica,18835,13,0,0,13
Haloclava producta,17416,13,0,0,13
Heteractis aurora,19999,13,0,0,13
Heteractis crispa,18835,13,0,0,13
Liponema brevicorne,19143,13,0,0,13
Eysarcoris guttigerus,15368,13,22,2,37
Anaxyrus americanus,17328,13,22,2,37
Bufotes pewzowi,17551,13,22,2,37
Favonigobius gymnauchen,16480,13,22,2,37
Hydrolagus affinis,17003,13,22,2,37
Carcharhinus amblyrhynchos,16705,13,22,2,37
Carcharhinus albimarginatus,16706,13,22,2,37
Schistosoma indicum,16901,12,22,2,36
Rhynchobatus laevis,16560,13,22,2,37
Phauda flammans,15470,13,22,2,37
Geopelia cuneata,17880,13,22,2,37
Myrmeleon formicarius,16179,13,22,2,37
Cryptalaus larvatus,15876,13,22,2,37
Siniperca fortis,16495,13,22,2,37
Synchiropus sycorax,16656,13,22,2,37
Pyralis farinalis,15204,13,22,2,37
Orthopygia glaucinalis,15229,13,22,2,37
Geocapromys ingrahami,16579,13,22,2,37
Parnassius mercurius,15372,13,22,2,37
Synalpheus microneptunus,15603,13,22,2,37
Hydrotaea dentipes,16069,13,22,2,37
Sarcophaga brevicornis,15152,13,22,2,37
Sarcophaga tuberosa,15173,13,22,2,37
Gymnocypris waddellii,16674,13,22,2,37
Gymnodiptychus pachycheilus weiheensis,16680,13,22,2,37
Meitanaphis microgallis,16191,13,22,2,37
Nierstraszella lineata,15765,13,22,2,37
Leptochiton nexus,15488,13,23,2,38
Hanleyella oldroydi,15692,13,23,2,38
Dendrochiton gothicus,15288,13,22,2,37
Chiton albolineatus,14936,13,22,2,37
Acanthochitona avicula,15203,13,22,2,37
Eospalax rufescens,16355,13,22,2,37
Lepisma saccharina,15244,13,22,2,37
Blaps rhynchoptera,16149,13,22,2,37
Acrossocheilus longipinnis,16593,13,22,2,37
Pontia edusa,15125,13,22,2,37
Delias pasithoe,15203,13,22,2,37
Dahlica ochrostigma,15429,13,22,2,37
Paraahimia luodianensis,16497,13,22,2,37
Mitjaevia protuberanta,15472,13,22,2,37
Aulacophora indica,16246,13,22,2,37
Mansonia uniformis,15603,13,22,2,37
Benthosema pterotum,18052,13,22,2,37
Trichoderma atroviride,32758,21,27,2,50
Trifolium pratense,301823,32,17,3,52
Trifolium meduseum,348724,37,18,3,58
Trifolium grandiflorum,347723,32,19,3,54
Trifolium aureum,294911,32,19,3,54
Antarctomyces pellizariae,30121,14,17,2,33
Codium fragile,45971,31,22,2,55
Schizosaccharomyces pombe,19431,10,25,2,37
Yarrowia phangngaensis,28017,15,25,2,42
Pseudohemiculter dispar,16620,13,22,2,37
Glyphis glyphis,16701,13,22,2,37
Kluyveromyces marxianus,46256,10,20,2,32
Eukaryota sp. BB2 Eukaryota.,119311,44,25,2,71
Heterodermia speciosa,75318,29,24,2,55
Sophora flavescens,494369,51,23,3,77
Camellia sinensis,707441,32,23,2,57
Daubentonia madagascariensis,16620,13,22,2,37
Jaagichlorella hainangensis,54084,30,20,3,53
Mirabilis himalaica,346363,41,27,4,72
Anthoceros punctatus,228048,42,20,3,65
Anthoceros agrestis,228021,42,20,3,65
Rotheca serrata,482114,34,15,3,52
Nemania diffusa,258879,14,25,2,41
Orbiocrella petchii,23794,16,24,2,42
Ophiocordycipitaceae sp.,66785,31,17,2,50
Omphalotus japonicus,157545,15,23,2,40
Magnolia biondii,967100,42,28,3,73
Scaphirhynchus albus,16494,13,22,2,37
Colletotrichum scovillei,30952,2,0,0,2
Malaza empyreus,16103,13,22,2,37
Malaza carmides,15380,13,22,2,37
Rachelia extrusus,16114,13,22,2,37
Chorthippus fallax,16143,13,22,2,37
Shoveliteratura triangula,16152,13,22,2,37
Lyperosomum longicauda,14567,12,22,2,36
Squatina dumeril,16692,13,22,2,37
Calandrella cinerea,17383,13,22,2,37
Eremophila alpestris,17855,13,22,2,37
Scythris sinensis,15216,13,22,2,37
Altica viridicyanea,16706,13,22,2,37
Argonauta nodosa,15201,13,22,2,37
Furipterus horrens,16516,13,22,2,37
Marmota vancouverensis,16435,13,22,2,37
Trichopria drosophilae,16375,13,22,2,37
Hermissenda emurai,13880,13,22,2,37
Phyllidiella pustulosa,14717,13,22,2,37
Paulhutchinsonia pilosicollis,15846,13,22,2,37
Hirundo tahitica,18038,13,22,2,37
Muntiacus gongshanensis,16356,13,22,2,37
Empoascanara sipra,14827,13,22,2,37
Hemerobius japonicus,18585,13,22,2,37
Scincella modesta,17511,13,22,2,37
Greenidea ficicola,17361,13,22,2,37
Enterogyrus malmbergi,14107,12,22,2,36
Iphisa elegans,18622,13,22,2,37
Allorhynchium sp. GX,19646,13,23,2,38
Allorhynchium sp. YN,19198,13,23,2,38
Antodynerus aff. limbatus YN,17975,13,23,2,38
Rhynchium aff. brunneum YN,23251,13,23,2,38
Rhynchium aff. brunneum GX,23122,13,23,2,38
Ostrinia scapulalis,15311,13,22,2,37
Ostrinia zealis,15208,13,22,2,37
Neoplocaederus obesus,15683,13,22,2,37
Anguis veronensis,17322,13,22,2,37
Kirchnerius guangxii,14562,13,22,2,37
Nassarius siquijorensis,15337,13,22,2,37
Carijoa riisei,18714,14,1,2,17
Bathyraja eatonii,16698,13,22,2,37
Trematomus loennbergii,19374,13,22,2,37
Corydoras sterbai,16636,13,22,2,37
Arius dispar,16792,13,22,2,37
Anguis colchica,17097,13,22,2,37
Anguis graeca,19297,15,26,2,43
Chaetodon wiebeli,16523,13,22,2,37
Thalassoma lunare,17073,13,22,2,37
Prometheomys schaposchnikovi,16284,13,22,2,37
Rattus hoogerwerfi,16314,13,22,2,37
Rattus sp. NH 2147,16308,13,22,2,37
Rattus korinchi,16312,13,22,2,37
Hygrobates longiporus,13721,13,22,2,37
Zeugodacus proprediaphora,15829,13,22,2,37
Anemonia sulcata,20390,13,0,0,13
Entacmaea quadricolor,20960,13,0,0,13
Orientocoluber spinalis,17196,13,22,2,37
Diplostomum ardeae,14037,12,22,2,36
Cofana yasumatsui,15019,13,22,2,37
Dolichoderus quadripunctatus,16017,13,22,2,37
Nassarius glans,15296,13,22,2,37
Alphitobius diaperinus,15511,13,22,2,37
Corydoras duplicareus,16667,13,22,2,37
Corydoras arcuatus,16822,13,22,2,37
Corydoras panda,16611,13,22,2,37
Corydoras trilineatus,16526,13,22,2,37
Praomys rostratus,16246,13,22,2,37
Otomys irroratus,16251,13,22,2,37
Mus baoulei,16299,13,23,2,38
Melomys burtoni,16250,13,22,2,37
Maxomys whiteheadi,16275,13,22,2,37
Heimyscus fumosus,16246,13,22,2,37
Chiropodomys gliroides,16262,13,22,2,37
Apodemus sylvaticus,16308,13,22,2,37
Scaptochirus moschatus,16763,13,22,2,37
Phytomia zonata,15716,13,22,2,37
Oryzias celebensis,16493,13,22,2,37
Phascolosoma similis,16237,13,23,2,38
Siphonosoma cumanense,15917,13,23,2,38
Nemipterus hexodon,17115,13,22,2,37
Dentex hypselosomus,16618,13,22,2,37
Otaria byronia,16643,13,22,2,37
Microtus richardsoni,16285,13,22,2,37
Hierodula membranacea,16122,13,22,2,37
Eospalax smithii,16350,13,22,2,37
Abbottina binhi,16609,13,22,2,37
Columba hodgsonii,17477,13,22,2,37
Dremomys everetti,16178,13,22,2,37
Bottapotamon lingchuanense,17612,13,22,2,37
Neilupotamon xinganense,16965,13,22,2,37
Daldorfia horrida,15737,13,22,2,37
Carpilius maculatus,15761,13,22,2,37
Linuparus trigonus,15949,13,22,2,37
Sundasciurus altitudinis,16308,13,22,2,37
Sundasciurus robinsoni,16324,13,22,2,37
Sundasciurus hippurus,16299,13,22,2,37
Allactaga williamsi,16653,13,22,2,37
Brassica rapa,219736,77,18,3,98
Dictyophora indusiata,89139,51,24,2,77
Phallus echinovolvatus,50098,26,24,2,52
Metschnikowia kamakouana,52527,14,25,2,41
Lamprotula coreana,15697,13,22,2,37
Hydrotaea aenescens,15238,13,22,2,37
Birgus latro,16411,13,22,2,37
Calonectria ilicicola,39891,20,26,2,48
Polyphaga plancyi,15636,13,22,2,37
Erromyzon sinensis,16560,13,22,2,37
Ctenocephalides felis,20873,13,22,2,37
Aphaenogaster famelica,19464,13,22,2,37
Ochetellus glaber,16259,13,22,2,37
Nylanderia flavipes,16687,13,22,2,37
Oreolalax omeimontis,17675,13,22,2,37
Somniosus microcephalus,16730,13,22,2,37
Raja brachyura,16925,13,22,2,37
Alopias vulpinus,16700,13,22,2,37
Spirocodon saltatrix,15752,13,2,2,17
Myotis septentrionalis,17150,13,22,2,37
Azygia hwangtsiyui,13973,12,22,2,36
Lysmata vittata,22003,13,22,2,37
Galeus melastomus,16706,13,22,2,37
Rajella lintea,16720,13,22,2,37
Neodontobutis hainanensis,16498,13,22,2,37
Alviniconcha boucheti,15981,13,22,2,37
Bothrogonia qiongana,15788,13,22,2,37
Bothrogonia tongmaiana,15539,13,22,2,37
Bothrogonia yunana,15585,13,22,2,37
Amphioctopus neglectus,15747,13,22,2,37
Darevskia derjugini,16960,13,22,2,37
Darevskia caucasica,16343,13,22,2,37
Darevskia praticola,16418,13,22,2,37
Darevskia raddei,20478,13,22,2,37
Darevskia clarkorum,16301,13,22,2,37
Darevskia daghestanica,17189,13,22,2,37
Darevskia chlorogaster,17479,13,22,2,37
Darevskia brauneri,16976,13,22,2,37
Guerlinguetus brasiliensis,16511,13,22,2,37
Sciurus arizonensis,16519,13,22,2,37
Sciurus carolinensis,16516,13,22,2,37
Sciurus colliaei,16519,13,22,2,37
Sciurus nayaritensis,16521,13,22,2,37
Sciurus variegatoides,16521,13,22,2,37
Sciurus yucatanensis,16519,13,22,2,37
Sciurus pucheranii,16504,13,22,2,37
Sciurus granatensis,16515,13,22,2,37
Microsciurus mimulus,16504,13,22,2,37
Microsciurus otinus,16516,13,22,2,37
Microsciurus similis,16520,13,22,2,37
Simosciurus nebouxii,16511,13,22,2,37
Simosciurus stramineus,16512,13,22,2,37
Guerlinguetus aestuans,16521,13,22,2,37
Glaucomys volans,16535,13,22,2,37
Hadrosciurus igniventris,16518,13,22,2,37
Hadrosciurus pyrrhinus,16522,13,22,2,37
Hadrosciurus spadiceus,16515,13,22,2,37
Microsciurus flaviventer,16521,13,22,2,37
Microsciurus sabanillae,16524,13,22,2,37
Sciurus ignitus,16519,13,22,2,37
Sciurus lis,16512,13,22,2,37
Sciurus griseus,16520,13,22,2,37
Aedes flavopictus,16060,13,22,2,37
Cyclograpsus intermedius,16184,13,22,2,37
Centropus bengalensis,17117,13,22,2,37
Obrimoposthia wandeli,15185,12,22,2,36
Amblema plicata,15946,13,22,2,37
Pleurobema oviforme,15852,13,22,2,37
Popenaias popeii,15993,13,22,2,37
Lelecella limenitoides,15203,13,22,2,37
Monochamus alternatus alternatus,15880,13,22,2,37
Homo sapiens,16569,13,22,2,37
Cavia porcellus,16801,13,22,2,37
Saccharomyces paradoxus,71355,14,24,2,40
Talaromyces marneffei,35438,25,28,2,55
Ochromonas danica,41035,44,29,2,75
Hydrotaea chalcogaster,15279,13,22,2,37
Metschnikowia colocasiae,62609,14,25,2,41
Metschnikowia mauinuiana,55476,21,47,3,71
Metschnikowia arizonensis,187475,14,27,2,43
Metschnikowia cubensis,116310,16,25,2,43
Chorisodontium aciphyllum,105766,40,24,3,67
Solanum melongena,482343,48,32,4,84
Solanum aethiopicum,566695,43,31,6,80
Solanum torvum,420342,34,19,2,55
Metschnikowia drakensbergensis,113475,14,25,2,41
Metschnikowia proteae,121495,14,25,2,41
Metschnikowia hawaiiensis,51759,14,25,2,41
Metschnikowia continentalis,79731,14,27,2,43
Metschnikowia dekortorum,79835,14,26,2,42
Metschnikowia agaves,61425,14,26,2,42
Metschnikowia cerradonensis,92261,14,26,2,42
Metschnikowia lochheadii,76321,14,26,2,42
Metschnikowia sp. 13-106.1,105181,14,25,2,41
Metschnikowia borealis,96587,14,25,2,41
Metschnikowia aberdeeniae,69221,14,25,2,41
Metschnikowia shivogae,81198,14,25,2,41
Metschnikowia santaceciliae,81062,14,27,2,43
[Candida] ipomoeae,77864,14,25,2,41
Metschnikowia matae var. maris,75407,14,27,0,41
Metschnikowia matae,82136,14,28,2,44
Metschnikowia hamakuensis,43542,21,47,3,71
Carpoglyphus lactis,14060,13,22,2,37
Schismatogobius marmoratus,16634,13,22,2,37
Embiotoca jacksoni,16515,13,22,2,37
Luffa acutangula,460333,54,37,6,97
Microphis deocata,16526,13,22,2,37
Sphyraena pinguis,16620,13,22,2,37
Palomena viridissima,15118,13,22,2,37
Nysius fuscovittatus,14575,13,22,2,37
Palaemon adspersus,15736,13,22,2,37
Vespa mandarinia,20831,13,22,2,37
Eucidaris tribuloides,15803,13,22,2,37
Amblyomma ovale,14760,13,22,2,37
Nabis ferus,15290,13,21,2,36
Roxasellana stellata,15361,13,22,2,37
Drabescus ineffectus,15744,13,22,2,37
Erythrogenys gravivox dedekensi,16996,13,22,2,37
Issoria eugenia,15206,13,22,2,37
Manayunkia occidentalis,15103,13,22,2,37
Hystrix brachyura,16833,13,22,2,37
Muscardinus avellanarius,16731,13,22,2,37
Lagenorhynchus acutus,16384,13,22,2,37
Palaemon serratus,15758,13,22,2,37
Caecobarbus geertsii,16565,13,22,2,37
Prionocidaris baculosa,15836,13,22,2,37
Stylocidaris reini,15850,13,22,2,37
Echinothrix calamaris,15716,13,22,2,37
Pseudoboletia maculata,15754,13,22,2,37
Colobocentrotus mertensii,15739,13,22,2,37
Hirundo atrocaerulea,18093,13,22,2,37
Ephemerella sp. Yunnan-2018,15256,13,22,2,37
Serratella sp. Liaoning-2019,15523,13,22,2,37
Serratella sp. Yunnan-2018,15134,13,22,2,37
Serratella zapekinae,15703,13,22,2,37
Torleya grandiforceps,15330,13,24,2,39
Torleya nepalica,15599,13,24,2,39
Hirundo smithii,18116,13,22,2,37
Hirundo angolensis,18141,13,22,2,37
Hirundo dimidiata,17997,13,22,2,37
Fulvetta vinipectus,16961,13,22,2,37
Hirundo neoxena,18039,13,22,2,37
Hirundo nigrita,18037,13,22,2,37
Hirundo aethiopica,18022,13,22,2,37
Caryopemon giganteus,15727,13,22,2,37
Hirundo rustica transitiva,17893,13,21,2,36
Hirundo rustica tytleri,18051,13,22,2,37
Delichon urbicum,17973,13,22,2,37
Hirundo albigularis,18145,13,22,2,37
Praia tianmunica,15556,13,22,2,37
Eubranchipus grubii,16328,13,22,2,37
Potamophylax latipennis,16502,13,22,2,37
Pegoplata infirma,15096,13,22,2,37
Elodes minuta,16532,13,22,2,37
Orthonevra geniculata,15858,13,22,2,37
Ptychoptera minuta,15538,13,22,2,37
Norellisoma spinimanum,14953,13,22,2,37
Hylemya vagans,15365,13,22,2,37
Acnemia nitidicollis,16950,13,22,2,37
Tipula fascipennis,15701,13,22,2,37
Simulium noelleri,16323,13,22,2,37
Phryganea bipunctata,14917,13,22,2,37
Protonemura meyeri,15695,13,22,2,37
Cataclysta lemnata,15333,13,22,2,37
Triatoma mexicana,15699,13,22,2,37
Triatoma huehuetenanguensis,15910,13,22,2,37
Triatoma lecticularia,16067,13,22,2,37
Triatoma mazzottii,15962,13,22,2,37
Rhodnius prolixus,15790,13,22,2,37
Triatoma sanguisuga,15421,13,22,2,37
Elaphodus cephalophus cephalophus,16351,13,22,2,37
Spilosoma lubricipeda,15375,13,22,2,37
Coenobita brevimanus,16393,13,22,2,37
Malaza fastuosus,15579,13,22,2,37
Graffilla buccinicola,14369,12,23,2,37
Syndesmis echinorum,15053,13,23,2,38
Pagodroma nivea,17279,13,22,2,37
Megalobrama amblycephala x Elopichthys bambusa,16623,13,22,2,37
Saurogobio gracilicaudatus,16608,13,22,2,37
Saurogobio xiangjiangensis,16600,13,22,2,37
Saurogobio gymnocheilus,16604,13,22,2,37
Saurogobio lissilabris,16594,13,22,2,37
Lepus yarkandensis,17011,13,22,2,37
Sargassum siliquastrum,34765,37,25,3,65
Wolfiporia cocos,135686,46,28,2,76
Anopheles cruzii,15287,13,22,2,37
Elaeidobius kamerunicus,17729,13,22,2,37
Metschnikowia kipukae,33454,14,25,2,41
Metschnikowia amazonensis,132631,14,25,2,41
[Candida] torresii,48347,14,23,2,39
Metschnikowia drosophilae,33514,14,22,2,38
Metschnikowia caudata,24050,14,23,2,39
Metschnikowia orientalis,56695,14,23,1,38
[Candida] hawaiiana,35585,14,25,2,41
Metschnikowia bowlesiae,93037,14,25,2,41
Metschnikowia similis,99200,14,25,2,41
Metschnikowia hibisci,67292,15,25,2,42
Sanghuangporus vaninii,97345,23,28,2,53
Cladosporium sphaerospermum,35706,17,26,2,45
Melicope pteleifolia,159012,83,37,8,128
Passiflora edulis,680480,41,30,3,74
Fagus sylvatica,504715,57,19,3,79
Sapindus mukorossi,602121,41,22,4,67
Zygotorulaspora mrakii,37644,0,0,0,0
Letharia lupina,71706,2,0,0,2
Fusarium subglutinans,1141,0,0,0,0
Fusarium tjaetaba,28118,0,0,0,0
Plasmodium vinckei vinckei,6003,3,0,0,3
Friesea antarctica,15425,13,22,2,37
Squalidus chankaensis,16611,13,22,2,37
Araschnia levana,15207,13,22,2,37
Osmylus fulvicephalus,16280,13,22,2,37
Paratectonatica tigrina,15201,13,22,2,37
Tanea lineata,15156,13,22,2,37
Tropidophorus hangnam,16777,13,22,2,37
Bufotes sitibundus,17135,13,22,2,37
Metacarcinus magister,39658,13,26,2,41
Lysmata amboinensis,16735,13,22,2,37
Saron marmoratus,16330,13,22,2,37
Hediste japonica,15783,13,22,2,37
Chloebia gouldiae,16830,13,22,2,37
Callithrix aurita,16471,13,22,2,37
Tridacna gigas,19558,13,23,2,38
Notothenia rossii,18273,13,24,2,39
Taku spinosocarinatus,15960,13,22,2,37
Ptilorrhoa caerulescens,16878,13,22,2,37
Kallimoides rumia,15234,13,22,2,37
Mallika jacksoni,15193,13,22,2,37
Anopheles coustani,15408,13,22,2,37
Indochinamon bhumibol,16351,13,22,2,37
Trachypenaeus curvirostris,15968,13,22,2,37
Libellula angelina,15233,13,22,2,37
Molva dypterygia,16488,13,22,2,37
Natula pravdini,15817,13,22,2,37
Pseudodendrothrips mori,14568,13,22,2,37
Mesembrinibis cayennensis,16738,13,22,2,37
Semibalanus cariosus,15118,13,22,2,37
Prosopocoilus astacoides,17746,13,22,2,37
Omosita colon,16544,13,22,2,37
Mylabris calida,15149,13,22,2,37
Nephus oblongosignatus,16647,13,22,2,37
Macrosoma conifera,15344,13,22,2,37
Cervus canadensis,16428,13,22,2,37
Chroicocephalus brunnicephalus,16771,13,22,2,37
Tuta absoluta,15290,13,22,2,37
Triceratopyga calliphoroides,16529,13,23,2,38
Hyphessobrycon herbertaxelrodi,17417,13,22,2,37
Subclytia rotundiventris,15574,13,22,2,37
Sapajus flavius,16543,13,22,2,37
Odorrana graminea,18106,13,22,2,37
Pseudoscaphirhynchus kaufmanni,16597,13,22,2,37
Trigonopterus selaruensis,15529,13,22,2,37
Trigonopterus tanimbarensis,16993,13,22,2,37
Trigonopterus jasminae,17417,13,22,2,37
Trigonopterus triradiatus,16795,13,22,2,37
Trigonopterus singkawangensis,16742,13,22,2,37
Trigonopterus carinirostris,21007,13,22,2,37
Trigonopterus kotamobagensis,18038,13,22,2,37
Trigonopterus porg,15346,13,22,2,37
Pareas boulengeri,18190,13,22,2,37
Hyalopterus pruni,15410,13,22,2,37
Lethe baileyi,15225,13,22,2,37
Lethe baucis,15251,13,22,2,37
Lethe hayashii,15246,13,22,2,37
Lethe helle,15253,13,22,2,37
Lethe marginalis,15229,13,22,2,37
Lethe nigrifascia,15239,13,22,2,37
Lethe oculatissima,15243,13,22,2,37
Lethe satyrina,15271,13,22,2,37
Lethe syrcis,15252,13,22,2,37
Lethe titania,15257,13,22,2,37
Lethe uemurai,15272,13,22,2,37
Lethe verma,15239,13,22,2,37
Prosthogonimus cuneatus,14829,12,22,2,36
Cynoglossus nanhaiensis,17130,13,22,2,37
Crenidorsum turpiniae,15427,13,22,2,37
Eristalis cerealis,15348,13,22,2,37
Chrysomela vigintipunctata,17474,13,22,2,37
Ectophasia rotundiventris,15792,13,22,2,37
Hamamelistes spinosus,15089,13,22,2,37
Hotaria unmunsana,15858,13,22,2,37
Pseudocrangonyx joolaei,14814,13,22,2,37
Inimicus japonicus,16978,13,22,2,37
Melanostoma scalare,16380,13,22,2,37
Syrphus vitripennis,16185,13,22,2,37
Mareca penelope,16596,13,22,2,37
Anax parthenope,15306,13,22,2,37
Prolixicheilus longisulcus,16598,13,22,2,37
Balitora ludongensis,16576,13,22,2,37
Populicerus confusus,16395,13,22,2,37
Lepus oiostolus,17370,13,22,2,37
Littorina brevicula,16356,13,22,2,37
Antechinus arktos,17334,13,22,2,37
Villorita cyprinoides,15880,13,22,2,37
Tupaia tana,16186,13,22,2,37
Tupaia minor,16187,13,22,2,37
Tupaia splendidula,16189,13,22,2,37
Lasionycteris noctivagans,16175,13,22,2,37
Cletus punctiger,16166,13,22,2,37
Hemerobius spodipennis,16343,13,22,2,37
Acanthisitta chloris,16935,13,22,2,37
Tachuris rubrigastra,17134,13,22,2,37
Ptilorrhoa leucosticta,16874,13,22,2,37
Chaetorhynchus papuensis,16956,13,22,2,37
Cephalopterus ornatus,17003,13,22,2,37
Grallaria varia,16901,13,22,2,37
Sclerurus mexicanus,16930,13,22,2,37
Sakesphorus luctuosus,16940,13,22,2,37
Campylorhamphus procurvoides,16936,13,22,2,37
Catharus fuscescens,16766,13,22,2,37
Regulus satrapa,16854,13,22,2,37
Loxia leucoptera,16811,13,22,2,37
Vireo altiloquus,17193,13,22,2,37
Edolisoma coerulescens,16925,13,22,2,37
Irena cyanogastra,16837,13,22,2,37
Pachycephala philippinensis,16893,13,22,2,37
Rhabdornis inornatus,16840,13,22,2,37
Quiscalus mexicanus,16772,13,22,2,37
Myiagra hebetior,16928,13,22,2,37
Dicaeum eximium,16832,13,22,2,37
Leptocoma aspasia,16919,13,22,2,37
Tyrannus savana,17112,13,22,2,37
Formicarius rufipectus,16781,13,22,2,37
Setophaga kirtlandii,16807,13,22,2,37
Dicrurus megarhynchus,16979,13,22,2,37
Rhipidura dahli,16870,13,22,2,37
Lanius ludovicianus,16947,13,22,2,37
Polioptila caerulea,16764,13,22,2,37
Thryothorus ludovicianus,16794,13,22,2,37
Hylia prasina,16891,13,22,2,37
Platysteira castanea,16909,13,22,2,37
Pachyramphus minor,17019,13,22,2,37
Oenanthe oenanthe,16826,13,22,2,37
Cinclus mexicanus,16818,13,22,2,37
Ploceus nigricollis,16903,13,22,2,37
Osmundea sinicola,25021,22,20,2,44
Ankistrodesmus falcatus,41048,21,25,5,51
Monilinia laxa,178357,109,32,2,143
Scopulariopsis brevicaulis,28829,15,25,2,42
Helianthus grosseserratus,273543,38,21,3,62
Helianthus strumosus,281056,43,22,3,68
Cyanidiococcus yangmingshanensis,32424,34,15,1,50
Mengenilla moldrzyki,15363,13,22,2,37
Cancer pagurus,42736,13,28,2,43
Apis mellifera,16445,13,22,2,37
Gymnorhina tibicen,16866,13,22,2,37
Pitta sordida,17733,13,22,2,37
Pomatostomus ruficeps,15673,13,22,2,37
Aphelocoma coerulescens,16907,13,22,2,37
Sitta villosa,16816,13,22,2,37
Nucifraga caryocatactes,16914,13,22,2,37
Perinereis cultrifera,17056,13,22,2,37
Pieris napi,15178,13,22,2,37
Pomacentrus moluccensis,16801,13,22,2,37
Sternoptyx diaphana,17224,13,22,2,37
Molothrus ater,16758,13,22,2,37
Stenocephalemys griseicauda,16247,13,22,2,37
Stenocephalemys albocaudata,16245,13,22,2,37
Chelonoidis darwini,15661,13,21,2,36
Chelonoidis becki,15661,13,21,2,36
Chelonoidis vicina,15661,13,21,2,36
Chelonoidis porteri,15661,13,21,2,36
Chelonoidis hoodensis,15661,13,21,2,36
Chelonoidis abingdonii,16449,13,22,2,37
Coenomyia ferruginea,17283,13,22,2,37
Perisesarma bidens,15641,13,22,2,37
Carpodacus pulcherrimus,16797,13,22,2,37
Pelobates fuscus,16828,13,22,2,37
Holothuria edulis,15743,13,22,2,37
Dario dario,16830,13,22,2,37
Sporophila hypoxantha,16778,13,22,2,37
Hapalochlaena fasciata,15479,13,22,2,37
Acanthorhynchus tenuirostris,16614,13,22,2,37
Xiphorhynchus elegans,16943,13,22,2,37
Nematobrycon palmeri,17340,13,22,2,37
Arma custos,15629,13,22,2,37
Monomorium pharaonis,15942,13,22,2,37
Sarcophaga scopariiformis,15325,13,22,2,37
Yasuhikotakia eos,16738,13,22,2,37
Microphysogobio tungtingensis,16627,13,22,2,37
Grammatorcynus bilineatus,16537,13,22,2,37
Nesospiza acunhae,16783,13,22,2,37
Brycon nattereri,16837,13,22,2,37
Pterocryptis anomala,16584,13,22,2,37
Cucujus mniszechi,15488,13,22,2,37
Carangoides plagiotaenia,16551,13,22,2,37
Rhegmatorhina hoffmannsi,16891,13,22,2,37
Phylloscopus examinandus,16881,13,22,2,37
Stenocephalemys albipes,16247,13,22,2,37
Macrostemum floridum,15424,13,22,2,37
Pedetontus zhejiangensis,15602,13,22,2,37
Habropoda radoszkowskii,18497,13,22,2,37
Cinclosoma punctatum,16849,13,22,2,37
Myzornis pyrrhoura,17397,13,22,2,37
Thor amboinensis,15553,13,22,2,37
Betta mahachaiensis,16980,13,22,2,37
Setipinna tenuifilis,16883,13,22,2,37
Paedocypris carbunculus,17280,13,22,2,37
Platynereis bicanaliculata,15868,13,22,2,37
Alitta succinea,15409,13,22,2,37
Paedocypris micromegethes,17208,13,22,2,37
Scyllarides haanii,15666,13,22,2,37
Cinclosoma castanotum,16823,13,22,2,37
Chelonoidis duncanensis,15661,13,21,2,36
Ilisha striatula,16847,13,22,2,37
Corvus moneduloides,16894,13,22,2,37
Leptopeza flavipes,15267,13,22,2,37
Linguatula arctica,14789,13,22,2,37
Deporaus marginatus,16873,13,22,2,37
Chalcidica minea,15490,13,22,2,37
Stenopsyche angustata,15371,13,22,2,37
Hymaea magna,16888,13,22,2,37
Platynereis massiliensis,17502,13,23,2,38
Cinclosoma clarum,16824,13,22,2,37
Chelonoidis donfaustoi,15661,13,21,2,36
Melanostoma orientale,16229,13,22,2,37
Olenecamptus bilobus,15262,13,22,2,37
Chrysocoris stollii,15766,13,22,2,37
Ectenagena elongata,16827,13,23,2,38
Encyrtus eulecaniumiae,15692,13,22,2,37
Encyrtus rhodococcusiae,15694,13,22,2,37
Encyrtus sasakii,15708,13,22,2,37
Sinopodisma pieli,15625,13,22,2,37
Zeuzera multistrigata,15320,13,22,2,37
Ricania shantungensis,15789,13,22,2,37
Colochirus quadrangularis,17157,13,22,2,37
Rivularia auriculata,16552,13,22,2,37
Chelonoidis vandenburghi,15661,13,21,2,36
Chelonoidis microphyes,15661,13,21,2,36
Chinapotamon maolanense,17130,13,22,2,37
Chelonoidis guntheri,15661,13,21,2,36
Nomia chalybeata,16692,13,22,2,37
Petalocephala chlorophana,14927,13,22,2,37
Platisus moerosus,15673,13,22,2,37
Cucujus kempi,15492,13,22,2,37
Platisus angusticollis,15921,13,22,2,37
Palaestes abruptus,15534,13,22,2,37
Pseudocolochirus violaceus,15756,13,22,2,37
Thesaurus albertalleni,15510,13,22,2,37
Diaphanes citrinus,18594,13,22,2,37
Chorocaris paulexa,15909,13,22,2,37
Epanerchodus koreanus,15581,13,22,2,37
Aclees cribratus,17329,13,22,2,37
Arria pallida,16240,13,22,2,37
Galegeeska revoilii,16578,13,22,2,37
Argyra pingwuensis,15859,13,22,2,37
Squalidus mantschuricus,16605,13,22,2,37
Squalidus longifilis,16607,13,22,2,37
Epipedocera atra,15662,13,22,2,37
Ancistrus temminckii,16657,13,22,2,37
Reticuluma hamata,15190,13,22,2,37
Rhombodera longa,15886,13,22,2,37
Pliacanthopus bimaculatus,15941,13,22,2,37
Stenocephalemys ruppi,16248,13,22,2,37
Stenocephalemys sokolovi,16251,13,22,2,37
Stenocephalemys zimai,16247,13,22,2,37
Anthalia sp. YD3030,15142,13,22,2,37
Sarcophaga kanoi,15319,13,22,2,37
Metidiocerus sp. ZB-2019,15079,13,22,2,37
Tituria sagittata,14918,13,22,2,37
Penthimia melanocephala,15308,13,22,2,37
Theileria annulata,5905,3,0,0,3
Anopheles medialis,15409,13,22,2,37
Rhodotorula toruloides,125937,25,28,2,55
Gelidiella acerosa,25281,23,23,2,48
Sorbus aucuparia,384977,34,23,2,59
Sorbus torminalis,386758,33,18,3,54
Sargassum patens,34844,37,25,3,65
Salix polaris,562920,23,21,3,47
Gelidiella fanii,25263,23,23,2,48
Salix cardiophylla,735173,28,25,3,56
Scapania ampliata,143664,42,27,3,72
Trichoderma lixii,29791,18,25,2,45
Gelidiella flabella,24948,23,20,2,45
Brettanomyces nanus,69606,0,20,0,20
Ascochyta rabiei,74173,0,0,0,0
Schistosoma haematobium,15003,12,22,2,36
Bubalus bubalis,16358,13,22,2,37
Tachypleus gigas,14956,13,22,2,37
Sarda sarda,16506,13,22,2,37
Osmerus eperlanus,16610,13,22,2,37
Chauna torquata,16766,13,22,2,37
Nothoprocta perdicaria,16964,13,22,2,37
Crotophaga sulcirostris,16933,13,22,2,37
Piaya cayana,17007,13,22,2,37
Rhipicephalus appendiculatus,15001,13,22,2,37
Paradisaea raggiana,16910,13,22,2,37
Fregata magnificens,16788,13,22,2,37
Pelecanoides urinatrix,17077,13,22,2,37
Orthonyx spaldingii,16916,13,22,2,37
Spizella passerina,16806,13,22,2,37
Neogobius melanostomus,16652,13,22,2,37
Climacteris rufus,16866,13,22,2,37
Aegotheles bennettii,16810,13,22,2,37
Crypturellus undulatus,17096,13,22,2,37
Steatornis caripensis,16908,13,22,2,37
Sitta europaea,16827,13,22,2,37
Charadrius vociferus,16808,13,22,2,37
Stercorarius parasiticus,16672,13,22,2,37
Aramus guarauna,16665,13,22,2,37
Psophia crepitans,17138,13,22,2,37
Phalacrocorax auritus,16646,13,22,2,37
Trogon melanurus,17280,13,22,2,37
Herpetotheres cachinnans,17329,13,22,2,37
Pholis gunnellus,16525,13,22,2,37
Colius striatus,17283,13,22,2,37
Panulirus longipes,15739,13,22,2,37
Rhipicephalus decoloratus,15268,13,22,2,37
Soriculus nigrescens,17284,13,22,2,37
Sylvia borin,17971,13,22,2,37
Certhia brachydactyla,16920,13,22,2,37
Asarcornis scutulata,16542,13,22,2,37
Oceanodroma tethys,17782,13,22,2,37
Oceanites oceanicus,17655,13,22,2,37
Nothoprocta ornata,17012,13,22,2,37
Dryoscopus gambensis,16854,13,22,2,37
Mullus surmuletus,16577,13,22,2,37
Ardeotis kori,17288,13,22,2,37
Echiichthys vipera,16924,13,23,2,38
Mystacornis crossleyi,16915,13,22,2,37
Toxostoma redivivum,16780,13,22,2,37
Corythaixoides concolor,16967,13,22,2,37
Erythrocercus mccallii,16878,13,22,2,37
Rhinopomastus cyanomelas,16778,13,22,2,37
Oxyruncus cristatus,17089,13,22,2,37
Bombycilla garrulus,16875,13,22,2,37
Leucopsar rothschildi,16845,13,22,2,37
Anapodisma miramae,15189,13,22,2,37
Brachypteracias leptosomus,17205,13,22,2,37
Bucco capensis,16679,13,22,2,37
Todus mexicanus,16998,13,22,2,37
Peucedramus taeniatus,16817,13,22,2,37
Panulirus penicillatus,15671,13,22,2,37
Plagiodera versicolora,16857,13,22,2,37
Anthoscopus minutus,16760,13,22,2,37
Phainopepla nitens,16847,13,22,2,37
Hypostomus ancistroides,16826,13,22,2,37
Zeugodacus cilifer,15843,13,22,2,37
Nymphalis c-aureum,15208,13,22,2,37
Centrolabrus exoletus,16494,13,22,2,37
Ctenolabrus rupestris,16495,13,22,2,37
Picathartes gymnocephalus,16887,13,22,2,37
Amazona guildingii,19229,13,22,2,37
Chloroceryle aenea,17789,13,22,2,37
Diopsittaca nobilis,16992,13,22,2,37
Oriolus oriolus,16794,13,22,2,37
Panurus biarmicus,17009,13,22,2,37
Struthidea cinerea,16931,13,22,2,37
Pycnonotus jocosus,16928,13,22,2,37
Vidua macroura,16874,13,22,2,37
Calcarius ornatus,16815,13,22,2,37
Chaetops frenatus,16795,13,22,2,37
Ferdinandea cuprea,15907,13,22,2,37
Oedaleus manjius,15590,13,22,2,37
Turdus abyssinicus,16707,13,22,2,37
Nicator chloris,17006,13,22,2,37
Tichodroma muraria,16801,13,22,2,37
Sapayoa aenigma,16945,13,22,2,37
Serilophus lunatus,16990,13,22,2,37
Burhinus bistriatus,16856,13,22,2,37
Dasyornis broadbenti,16841,13,22,2,37
Buphagus erythrorhynchus,16802,13,22,2,37
Spizaetus tyrannus,17479,13,22,2,37
Cnemophilus loriae,16848,13,22,2,37
Daphoenositta chrysoptera,16915,13,22,2,37
Falcunculus frontatus,16604,13,22,2,37
Melanocharis versteri,16752,13,22,2,37
Neodrepanis coruscans,16950,13,22,2,37
Pardalotus punctatus,16919,13,22,2,37
Gobiusculus flavescens,16401,13,22,2,37
Grantiella picta,16831,13,22,2,37
Chroicocephalus maculipennis,16792,13,22,2,37
Chionoecetes japonicus,16060,13,22,2,37
Epacromius coerulipes,15592,13,22,2,37
Apteryx rowi,16972,13,22,2,37
Scytalopus superciliaris,16883,13,22,2,37
Perkinsiella saccharicida,16429,13,22,2,37
Ochthebius glaber,16151,13,22,2,37
Circaetus pectoralis,17473,13,22,2,37
Eurystomus gularis,17379,13,22,2,37
Felderimyia fuscipennis,16536,13,22,2,37
Halcyon senegalensis,17211,13,22,2,37
Pteruthius melanotis,16862,13,22,2,37
Onychorhynchus coronatus,17033,13,22,2,37
Anemone maxima,1122546,40,18,3,61
Sebastes viviparus,16779,13,22,2,37
Lesueurigobius friesii,16493,13,22,2,37
Atrichornis clamosus,17284,13,22,2,37
Neopipo cinnamomea,17059,13,22,2,37
Chasmagnathus convexus,15107,13,22,1,36
Crypturellus soui,16705,13,22,2,37
Urocolius indicus,17267,13,22,2,37
Aleadryas rufinucha,16933,13,22,2,37
Eulacestoma nigropectus,16986,13,22,2,37
Ifrita kowaldi,16925,13,22,2,37
Ochotona coreana,17283,13,22,2,37
Furnarius figulus,16947,13,22,2,37
Aphis aurantii,15296,13,22,2,37
Chromis notata,16600,13,22,2,37
[Candida] auris,28212,15,23,2,40
Gekko subpalmatus,17105,13,22,2,37
Zeugopterus punctatus,16800,13,22,2,37
Schedophilus medusophagus,16651,13,22,2,37
Saccharomyces cerevisiae S288C,85779,19,24,2,45
Urocynchramus pylzowi,16879,13,22,2,37
Stichopus monotuberculatus,16274,13,22,2,37
Hypocryptadius cinnamomeus,16864,13,22,2,37
Drymodes brunneopygia,16851,13,22,2,37
Parophasma galinieri,16685,13,22,2,37
Chrysolina aeruginosa,16335,13,22,2,37
Pterodecta felderi,15340,13,22,2,37
Chloropsis hardwickii,16813,13,22,2,37
Ochthebius quadricollis,16510,13,22,2,37
Prunella himalayana,16842,13,22,2,37
Malurus elegans,16811,13,22,2,37
Origma solitaria,16846,13,22,2,37
Cossypha semirufa,16564,13,22,2,37
Ishiharodelphax matsuyamensis,16058,13,22,2,37
Ochthebius viridis,16002,13,22,2,37
Odontophorus gujanensis,16705,13,22,2,37
Crypturellus cinnamomeus,16870,13,22,2,37
Oligodon chinensis,17146,13,22,2,37
Ulva torta,65772,44,26,2,72
Oreocharis arfaki,17391,13,22,2,37
Erpornis zantholeuca,16903,13,22,2,37
Centropus unirufus,17089,13,22,2,37
Penelope pileata,16660,13,22,2,37
Machaerirhynchus nigripectus,16883,13,22,2,37
Chloropsis cyanopogon,16824,13,22,2,37
Sinopodisma rostellocerca,15622,13,22,2,37
Gymnammodytes semisquamatus,16484,13,22,2,37
Epeurysa nawaii,15536,13,22,2,37
Ochthebius atriceps,16182,13,22,2,37
Ochthebius capicola,16114,13,22,2,37
Ochthebius hasegawai,16085,13,22,2,37
Ochthebius himalayae,16069,13,22,2,37
Ochthebius lividipennis,16054,13,22,2,37
Ochthebius magnannulatus,16148,13,22,2,37
Ochthebius mediterraneus,16148,13,22,2,37
Ochthebius nobilis,16074,13,22,2,37
Ochthebius puncticollis,17027,13,22,2,37
Ochthebius remotus,16083,13,22,2,37
Ochthebius salinarius,16280,13,22,2,37
Ochthebius sculptoides,16541,13,22,2,37
Ochthebius uniformis,16212,13,22,2,37
Ochthebius griotes,16126,13,22,2,37
Spondylis buprestoides,15837,13,22,2,37
Melaenornis chocolatinus,16582,13,22,2,37
Ophiura kinbergi,16521,13,22,2,37
Phyllidiopsis krempfi,14970,13,22,2,37
Ceuthmochares aereus,17187,13,22,2,37
Nothocercus nigrocapillus,16637,13,22,2,37
Bambusiphaga taibaishana,15721,13,22,2,37
Tropidocephala brunnipennis,16231,13,22,2,37
Gymnochthebius lividus,17647,13,22,2,37
Ochthebius scopuli,16181,13,22,2,37
Ulva sp. TM637,67506,43,26,2,71
Ulva sp. TM708,55814,36,27,2,65
Pharyngocirrus uchidai,15415,13,22,2,37
Turnix velox,16972,13,22,2,37
Bambusiphaga furca,15608,13,22,2,37
Chloriona tateyamana,16729,13,22,2,37
Horornis vulcanius,16990,13,22,2,37
Nothocercus julius,16695,13,22,2,37
Nothoprocta pentlandii,17013,13,22,2,37
Psilopogon haemacephalus,16839,13,22,2,37
Pterocles burchelli,18290,13,22,2,37
Rhadina sibilatrix,16876,13,22,2,37
Zapornia atra,16968,13,22,2,37
Octopus sinensis,15737,13,22,2,37
Bathytoshia brevicaudata,17640,13,22,2,37
Crithagra tristriata,16704,13,22,2,37
Chirolophis ascanii,16520,13,22,2,37
Ochthebius plesiotypus,16740,13,22,2,37
Platynereis cf. australis PA-2020,16037,13,22,2,37
Culter alburnus x Megalobrama terminalis,16622,13,22,2,37
Stenocatantops mistshenkoi,15573,13,22,2,37
Doleschallia melana,15269,13,22,2,37
Chionoecetes japonicus x Chionoecetes opilio,16037,13,22,2,37
Bryodema kozlovi,15930,13,22,2,37
Filchnerella rubrimargina,15661,13,22,2,37
Epinephelus akaara x Epinephelus tukula,16928,13,22,2,37
Epinephelus awoara x Epinephelus tukula,16801,13,22,2,37
Zyginella minuta,15544,13,22,2,37
Ochthebius minoicus,16252,13,22,2,37
Ochthebius deletus,16057,13,22,2,37
Eristalinus quinquestriatus,16198,13,22,2,37
Cyanidium caldarium,34207,34,25,2,61
Zonotrichia albicollis,16781,13,22,2,37
Lepidothrix coronata,17187,13,22,2,37
Galdieria phlegrea,21792,18,6,2,26
Cyanidium chilense,33039,35,23,3,61
Euonymus alatus,1045106,41,22,3,66
Asparagus officinalis,492062,36,17,6,59
Theileria taurotragi,5800,3,0,6,9
Edaphochlamys debaryana,19319,8,3,12,23
Ageratum conyzoides,219198,30,19,3,52
Climacium dendroides,104860,40,24,3,67
Glycyrrhiza uralensis,463869,40,28,3,71
Ulva rigida,88318,27,40,2,69
Theileria lestoquardi,5811,3,0,6,9
Ulva fenestrata,59026,19,44,2,65
Ulva australis,64466,20,31,2,53
Rhododendron simsii,802707,41,23,4,68
Wiesnerella denudata,186911,41,28,3,72
Schizocladia ischiensis,41628,33,26,3,62
Aconitum kusnezoffii,440720,37,29,3,69
Malania oleifera,527575,51,32,3,86
Ulva gigantea,66743,25,37,2,64
Ulva pseudorotundata,88416,24,29,2,55
Ulva laetevirens,79723,26,37,1,64
Beauveria lii,59014,30,23,2,55
Tuber calosporum,287403,18,14,2,34
Sarcopeltis skottsbergii,25908,24,22,2,48
Gallus gallus,16784,13,22,2,37
Trametes versicolor,67318,38,27,2,67
Halteria grandinella,50085,42,8,2,52
Pisolithus tinctorius,44054,22,25,2,49
Coregonus hoyi,16820,13,22,2,37
Trichosporon inkin,39466,22,24,2,48
Esox masquinongy,16729,13,22,2,37
Trametes coccinea,99976,54,27,2,83
Gila elegans,16593,13,22,2,37
Pisolithus microcarpus,43990,25,26,2,53
Esox niger,16775,13,22,2,37
Myurella julacea,104979,40,24,3,67
Douinia plicata,144205,42,27,3,72
Aquilaria sinensis,341829,32,18,3,53
Ptychocheilus lucius,16588,13,22,2,37
Diplophyllum taxifolium,144129,42,27,3,72
Pleurostomum flabellatum,57829,59,19,2,80
Pyrus betulifolia,469928,54,18,3,75
Eucampia zodiacus,36162,38,24,2,64
Cladobotryum mycophilum,78529,54,26,2,82
Semotilus corporalis,16602,13,22,2,37
Aspergillus cristatus,77649,15,25,2,42
Thelephora aurantiotincta,50672,15,25,2,42
Diaporthe nobilis,67437,21,28,2,51
Cyanophora biloba,39216,39,26,3,68
Cyanophora sudae,43295,47,26,3,76
Dorcus hansi,18130,13,22,2,37
Tolypocladium guangdongense,46102,30,27,2,59
Strombidium cf. sulcatum,54912,44,6,2,52
Gryllus bimaculatus,16075,13,22,2,37
Spodoptera littoralis,15408,13,22,2,37
Mellivora capensis,16579,13,22,2,37
Proteles cristata,17159,13,22,2,37
Phocoenoides dalli,16319,13,22,2,37
Tapirus terrestris,16772,13,22,2,37
Phocoena spinipinnis,16319,13,22,2,37
Ostrinia nubilalis,14838,13,22,2,37
Potos flavus,16581,13,22,2,37
Culcita novaeguineae,16377,13,22,2,37
Argas persicus,14426,13,22,2,37
Dermanyssus gallinae,16184,13,21,2,36
Stochomys longicaudatus,16266,13,22,2,37
Phocoena dioptrica,16319,13,22,2,37
Gymnobelideus leadbeateri,16812,13,22,2,37
Perna canaliculus,16004,13,23,2,38
Trematomus bernacchii,17586,13,22,2,37
Cynictis penicillata,16663,13,22,2,37
Phocoena sinus,16319,13,22,2,37
Aerodramus fuciphagus,16921,13,22,2,37
Blackfordia virginica,15109,13,2,2,17
Meteorus pulchricornis,16290,13,22,2,37
Lemniscomys barbarus,16274,13,22,2,37
Porzana pusilla,16966,13,22,2,37
Ictonyx striatus,16541,13,22,2,37
Ceratitis rosa,16047,13,22,2,37
Dictyosoma burgeri,16523,13,22,2,37
Odontaspis ferox,16682,13,22,2,37
Rhodinocichla rosea,16765,13,22,2,37
Rhinolophus affinis,16886,13,22,2,37
Gynaikothrips ficorum,15313,13,24,2,39
Crossaster papposus,16335,13,22,2,37
Arvicanthis somalicus,16272,13,22,2,37
Galidia elegans,16636,13,22,2,37
Callosobruchus maculatus,18321,13,22,2,37
Gila cypha,16591,13,22,2,37
Lasius spathepus,18951,13,22,2,37
Speothos venaticus,16975,13,22,2,37
Hybomys univittatus,16250,13,22,2,37
Dasymys incomtus,16273,13,22,2,37
Gila nigrescens,16585,13,22,2,37
Sebastes oculatus,16767,13,22,2,37
Eudyptes chrysolophus,17059,13,22,2,37
Viverra zibetha,16796,13,22,2,37
Arctictis binturong,16506,13,22,2,37
Chrotogale owstoni,16852,13,22,2,37
Cryptoprocta ferox,16862,13,22,2,37
Genetta genetta,16871,13,22,2,37
Teratoscincus roborowskii,16693,13,22,2,37
Eretes sticticus,16196,13,22,2,37
Brontispa longissima,15696,13,22,2,37
Calotes mystaceus,16506,13,22,2,37
Praomys delectorum,16235,13,22,2,37
Lemniscomys rosalia,16254,13,22,2,37
Mylomys dybowskii,16253,13,22,2,37
Golunda ellioti,16263,13,22,2,37
Desmomys harringtoni,16264,13,22,2,37
Appias nero,15099,13,22,2,37
Lophops carinata,15553,13,22,2,37
Spodoptera exempta,15457,13,22,2,37
Astyanax altiparanae,16730,13,22,2,37
Fossa fossana,16766,13,22,2,37
Deltistes luxatus,16623,13,22,2,37
Notropis jemezanus,16710,13,22,2,37
Ampullaceana lagotis,13751,13,22,2,37
Amyda cartilaginea,16763,13,22,2,37
Limosa haemastica,16695,13,22,2,37
Culex annulirostris,15572,13,22,2,37
Culex sitiens,15585,13,22,2,37
Otomys typus,16259,13,22,2,37
Kallima paralekta,15200,13,22,2,37
Gracilinanus agilis,16336,13,22,2,37
Parabotia kiangsiensis,16592,13,22,2,37
Phyllocnistis citrella,15416,13,22,2,37
Myoxocephalus quadricornis,16736,13,22,2,37
Galictis vittata,16495,13,22,2,37
Ichneumia albicauda,16651,13,22,2,37
Thaumetopoea pityocampa,15737,13,22,2,37
Parambassis ranga,17345,13,22,2,37
Atilax paludinosus,16654,13,22,2,37
Galerella sanguinea,16646,13,22,2,37
Herpestes naso,16650,13,22,2,37
Mungos mungo,16663,13,22,2,37
Galidictis fasciata,16632,13,22,2,37
Salanoia concolor,16798,13,22,2,37
Eupleres goudotii,16984,13,22,2,37
Acroneuria carolinensis,15718,13,22,2,37
Dermestes lardarius,15772,13,22,2,37
Psalidodon fasciatus,16626,13,22,2,37
Aphis spiraecola,15465,13,22,2,37
Sarcophaga carnaria,14952,13,22,2,37
Chitra vandijki,16614,13,22,2,37
Phoenicurus frontalis,16776,13,22,2,37
Sinergasilus undulatus,14239,13,22,2,37
Psittacula cyanocephala,16814,13,22,2,37
Bactrocera thailandica,15915,13,22,2,37
Scincella reevesii,15424,13,22,2,37
Ctenoplusia albostriata,15284,13,22,2,37
Halocynthia aurantium,14979,13,25,2,40
Pseudothemis zonata,15434,13,22,2,37
Culex australicus,15582,13,22,2,37
Papilio paris,15363,13,22,2,37
Hybognathus amarus,16714,13,22,2,37
Hyalomma asiaticum,14723,13,22,2,37
Hyphessobrycon megalopterus,16773,13,22,2,37
Pentatoma semiannulata,15515,13,22,2,37
Cobitis hankugensis,16554,13,22,2,37
Vormela peregusna,15982,13,22,2,37
Poecilogale albinucha,16518,13,22,2,37
Ostorhinchus novemfasciatus,16779,13,22,2,37
Lucilia papuensis,15323,13,22,2,37
Aromia bungii,15760,13,22,2,37
Bdeogale nigripes,16638,13,22,2,37
Gnathanodon speciosus,16555,13,22,2,37
Ellobius talpinus,16367,13,22,2,37
Cricetulus barabensis,16282,13,22,2,37
Thallomys paedulcus,16280,13,22,2,37
Thaparocleidus varicus,14088,12,22,2,36
Thaparocleidus asoti,16074,12,22,2,36
Neurothemis fulvia,15459,13,22,2,37
Certhia himalayana,16852,13,22,2,37
Dineutus mellyi,16123,13,22,2,37
Dionda diaboli,16799,13,22,2,37
Calliphora nigribarbis,16241,13,22,2,37
Onychostoma lepturum,16601,13,22,2,37
Anopheles annulipes,15350,13,22,2,37
Pachytriton brevipes,16301,13,22,2,37
Appias albina,15193,13,22,2,37
Branchinella kugenumaensis,14123,13,22,2,37
Sarcophaga josephi,14943,13,22,2,37
Abraximorpha davidii,15469,13,22,2,37
Odorrana exiliversabilis,17122,13,25,2,40
Catostomus discobolus,16623,13,22,2,37
Appias lyncida,15082,13,22,2,37
Colias fieldii,15150,13,22,2,37
Sycanus croceovittatus,15644,13,22,2,37
Micaelamys namaquensis,16236,13,22,2,37
Euretaster insignis,15954,13,22,2,37
Grammomys dolichurus,16333,13,22,2,37
Grammomys surdaster,16313,13,22,2,37
Scorpiops tibetanus,14825,13,22,2,37
Lycodes raridens,16569,13,22,2,37
Catostomus latipinnis,16624,13,22,2,37
Eutrichosiphum pasaniae,16500,13,22,2,37
Aedes alternans,16128,13,22,2,37
Protoreaster nodosus,16395,13,22,2,37
Trogoderma granarium,15505,13,22,2,37
Ceriagrion fallax,15350,13,22,2,37
Melanotus cribricollis,15908,13,22,2,37
Dorcus koreanus,17787,13,22,2,37
Haminoea japonica,13797,13,22,2,37
Aphidius gifuensis,20134,13,22,2,37
Cletus rubidiventris,15590,13,22,2,37
Nereis zonata,15757,13,22,2,37
Discogobio macrophysallidos,16593,13,22,2,37
Etisus dentatus,15884,13,22,2,37
Sinomicrurus macclellandi,17120,13,22,2,37
Tinda javana,15495,13,22,2,37
Anoplistes halodendri,15697,13,22,2,37
Dephomys defua,16252,13,22,2,37
Tupaia montana,16183,13,22,2,37
Pachytriton granulosus,16288,13,22,2,37
Mollitrichosiphum tenuicorpus,15727,13,22,2,37
Astyanax lacustris,16763,13,22,2,37
Psalidodon rivularis,16779,13,22,2,37
Stomaphis sinisalicis,17109,13,22,2,37
Sipalinus gigas,17120,13,22,2,37
Fistulobalanus albicostatus,15665,13,22,2,37
Dacus trimacula,15847,13,22,2,37
Crossarchus platycephalus,16846,13,22,2,37
Moolgarda perusii,16781,13,22,2,37
Oxyopes licenti,14431,13,22,2,37
Syrphus ribesii,16530,13,22,2,37
Protaeolidiella atra,14445,13,22,2,37
Sarcophaga depressifrons,14941,13,22,2,37
Sarcophaga schuetzei,14944,13,22,2,37
Sarcophaga aegyptica,14943,13,22,2,37
Sarcophaga jacobsoni,14944,13,22,2,37
Aplysina gerardogreeni,19620,14,25,2,41
Arhopalus unicolor,15760,13,22,2,37
Monochamus sparsutus,16029,13,22,2,37
Muscina pascuorum,14940,13,22,2,37
Sarcophaga macroauriculata,14943,13,22,2,37
Lamottemys okuensis,16243,13,22,2,37
Pollenia pediculata,15289,13,22,2,37
Hydrolagus mirabilis,19435,13,22,2,37
Togoperla limbata,15915,13,22,2,37
Sarcophaga pingi,14939,13,22,2,37
Fannia scalaris,15037,13,22,2,37
Promethis valgipes,15801,13,22,2,37
Neolissochilus benasi,16583,13,22,2,37
Schizoneuraphis gallarum,14990,13,22,2,37
Prunella rubeculoides,16796,13,22,2,37
Euconocephalus nasutus,14999,13,22,2,37
Yuukianura szeptyckii,15771,13,22,2,37
Tachysurus virgatus,16524,13,22,2,37
Cacopsylla citrisuga,14906,13,22,2,37
Dermestes ater,15812,13,22,2,37
Pimelocerus perforatus,15977,13,21,2,36
Mattiphus splendidus,15973,13,22,2,37
Necremnus tutae,15252,13,22,2,37
Polyphylla gracilicornis,16793,13,22,2,37
Solegnathus spinosissimus,16530,13,22,2,37
Prioneris clemanthe,15131,13,22,2,37
Dodona eugenes,15680,13,22,2,37
Calliphora uralensis,14971,13,22,2,37
Pnyxia scabiei,15437,13,22,2,37
Diachrysia nadeja,15242,13,22,2,37
Coquillettidia linealis,16441,13,22,2,37
Culiseta inconspicua,15888,13,22,2,37
Culex orbostiensis,15588,13,22,2,37
Aedes alboannulatus,16181,13,22,2,37
Aedes rubrithorax,15808,13,22,2,37
Ochlerotatus vittiger,16027,13,22,2,37
Tripteroides tasmaniensis,16403,13,22,2,37
Sarcophaga kentejana,14943,13,22,2,37
Culex cylindricus,15565,13,22,2,37
Ceratitis quilicii,16035,13,22,2,37
Gonocephalum sp. MT-2015-Zz052324,15836,13,22,2,37
Basilepta fulvipes,15762,13,22,2,37
Thamnomys kempi,16270,13,22,2,37
Parasinilabeo longicorpus,16596,13,22,2,37
Paralipsa gularis,15280,13,22,2,37
Paramesotriton aurantius,16313,13,22,2,37
Gryposmylus pennyi,16255,13,22,2,37
Pseudoxenodon stejnegeri,18475,13,26,2,41
Sarcophila latifrons,14936,13,22,2,37
Zoothera aurea,16712,13,22,2,37
Chodsigoa parva,17216,13,22,2,37
Bufonaria rana,15510,13,22,2,37
Anhinga melanogaster,17561,13,22,2,37
Hybomys planifrons,16253,13,22,2,37
Hybomys trivirgatus,16257,13,22,2,37
Matuta victor,15782,13,22,2,37
Svistella anhuiensis,16494,13,22,2,37
Mirocaris indica,15922,13,22,2,37
Epinephelus fuscoguttatus x Epinephelus polyphekadion,16648,13,22,2,37
Lophosquilla costata,15771,13,22,2,37
Mukaria splendida,16711,13,22,2,37
Crematogaster teranishii,17442,13,22,2,37
Arvicanthis rufinus,16262,13,22,2,37
Cicadetta abscondita,16026,13,22,2,37
Talpa aquitania,16826,13,22,2,37
Leptestheria brevirostris,15579,13,22,2,37
Aparapotamon similium,19236,13,22,2,37
Acropteris iphiata,15346,13,22,2,37
Iconaster longimanus,16142,13,22,2,37
Toxorhynchites speciosus,16109,13,22,2,37
Colobopsis nipponica,17431,13,22,2,37
Casmara patrona,15393,13,22,2,37
Ophidiaster granifer,16506,13,22,2,37
Anneissia pinguis,15912,13,22,2,37
Pentaceraster mammillatus,16325,13,22,2,37
Paurocephala sauteri,14963,13,22,2,37
Anthenea aspera,16298,13,22,2,37
Gonodactylaceus randalli,15907,13,22,2,37
Calliphora sinensis,16234,13,22,2,37
Polleniopsis mongolica,15647,13,22,2,37
Sarcophaga diminuta,14943,13,22,2,37
Sarcophaga graciliforceps,14943,13,22,2,37
Sarcophaga shnitnikovi,14944,13,22,2,37
Sarcophaga plotnikovi,14948,13,22,2,37
Sarcophaga cetu,14944,13,22,2,37
Sarcophaga kawayuensis,14943,13,22,2,37
Sarcophaga minor,14939,13,22,2,37
Sarcophaga anchoriformis,14943,13,22,2,37
Sarcophaga hervebazini,14939,13,22,2,37
Psylliodes chlorophana,14561,13,22,2,37
Hyporthodus septemfasciatus x Epinephelus lanceolatus,16559,13,22,2,37
Paraleuctra cercia,15625,13,22,2,37
Perlomyia isobeae,15795,13,22,2,37
Caryandoides hunanica,15555,13,22,2,37
Fer nigripennis,15669,13,22,2,37
Paratoacris reticulipennis,16321,13,22,2,37
Asyndetus clavipes,15385,13,22,2,37
Neurigona zhejiangensis,17141,13,22,2,37
Xanthochlorus tibetensis,15580,13,22,2,37
Neoasterolepisma foreli,15398,13,22,2,37
Allonychiurus kimi,14387,13,22,2,37
Cathayia obliquella,15408,13,22,2,37
Reticulitermes ovatilabrum,15913,13,22,2,37
Oxytauchira flange,16250,13,22,2,37
Cyriopagopus hainanus,13874,13,22,2,37
Sarcophaga pauciseta,16035,13,22,2,37
Grammomys selousi,16314,13,22,2,37
Laevistrombus canarium,15626,13,22,2,37
Tanyptera hebeiensis,15888,13,22,2,37
Hemipenthes neimengguensis,15405,13,22,2,37
Parastratiosphecomyia szechuanensis,16414,13,22,2,37
Parazyginella tiani,17562,13,22,2,37
Agelasta perplexa,15552,13,22,2,37
Cercodemas anceps,16539,13,22,2,37
Ptychoptera qinggouensis,15028,13,22,2,37
Eclipophleps carinata,15781,13,22,2,37
Nesotrochis steganinos,15576,13,22,2,37
Cerace xanthocosma,15344,13,22,2,37
Pungtungia herzi x Pseudopungtungia nigra,16601,13,22,2,37
Nasimyia megacephala,16069,13,22,2,37
Culex fergusoni,15653,13,22,2,37
Ochlerotatus nigrithorax,15943,13,22,2,37
Uvaroviola multispinosa,15620,13,22,2,37
Ludioschema sulcicolle,15848,13,22,2,37
Empis separata,14961,13,22,2,37
Acidiella diversa,15531,13,22,2,37
Oberea diversipes,15499,13,22,2,37
Condylura cristata,16709,13,22,2,37
Niviventer excelsior,16298,13,22,2,37
Epiplatys dageti,16575,13,22,2,37
Dictyocaulus viviparus,13310,12,22,2,36
Dictyocaulus eckerti,13300,12,22,2,36
Mya arenaria,17947,12,24,2,38
Ostrea lurida,16344,13,23,3,39
Calicogorgia granulosa,20246,14,1,2,17
Psephotellus pulcherrimus,17130,13,22,2,37
Macrophthalmus pacificus,17226,13,22,2,37
Falco naumanni,17652,13,22,2,37
Tinaminyssus melloi,14759,13,22,2,37
Ptilonyssus chloris,14433,13,22,2,37
Liposcelis decolor,14405,13,22,2,37
Appalachioria falcifera,15282,13,22,2,37
Debaryomyces hansenii,29462,18,25,2,45
Hydra vulgaris,7686,7,1,1,9
Schistosoma mansoni,14415,12,23,2,37
Aplysia californica,14117,13,22,2,37
Biomphalaria glabrata,13670,13,22,2,37
Octopus vulgaris,15744,13,22,2,37
Penaeus vannamei,15990,13,22,2,37
Limulus polyphemus,14985,13,22,2,37
Dermatophagoides pteronyssinus,14203,13,22,2,37
Acyrthosiphon pisum,16971,13,23,2,38
Bemisia tabaci,15322,13,22,2,37
Tribolium castaneum,15881,13,22,2,37
Bombyx mori,15643,13,22,2,37
Bombyx mandarina,15928,13,22,2,37
Manduca sexta,15516,13,22,2,37
Aedes albopictus,16665,13,22,2,37
Anopheles gambiae,15363,13,22,2,37
Ceratitis capitata,15980,13,22,2,37
Drosophila mauritiana,14964,13,22,2,37
Drosophila simulans,14972,13,22,2,37
Drosophila yakuba,16019,13,22,2,37
Apis cerana,15895,13,22,2,37
Apis mellifera ligustica,16343,13,22,2,37
Strongylocentrotus purpuratus,15650,13,22,2,37
Branchiostoma floridae,15083,13,22,2,37
Branchiostoma belcheri,15076,13,22,2,37
Petromyzon marinus,16201,13,22,2,37
Callorhinchus milii,16769,13,22,2,37
Latimeria chalumnae,16407,13,22,2,37
Lepisosteus oculatus,16330,13,22,2,37
Anguilla anguilla,16683,13,22,2,37
Clupea harengus,16701,13,22,2,37
Cyprinus carpio,16575,13,22,2,37
Ictalurus punctatus,16497,13,22,2,37
Esox lucius,16695,13,22,2,37
Oncorhynchus keta,16656,13,22,2,37
Oncorhynchus kisutch,16659,13,22,2,37
Oncorhynchus mykiss,16642,13,22,2,37
Oncorhynchus nerka,16658,13,22,2,37
Salmo salar,16665,13,22,2,37
Salvelinus alpinus,16659,13,22,2,37
Gadus morhua,16696,13,22,2,37
Fundulus heteroclitus,16526,13,22,2,37
Xiphophorus maculatus,16646,13,22,2,37
Xiphophorus hellerii,16635,13,22,2,37
Oryzias latipes,16714,13,22,2,37
Oreochromis niloticus,16627,13,22,2,37
Lates calcarifer,16535,13,22,2,37
Notothenia coriiceps,18347,13,22,2,37
Paralichthys olivaceus,17090,13,22,2,37
Xenopus laevis,17553,13,22,2,37
Xenopus tropicalis,17610,13,22,2,37
Chelonia mydas,16497,13,22,2,37
Chrysemys picta,16866,13,22,2,37
Alligator mississippiensis,16646,13,22,2,37
Crocodylus porosus,16916,13,22,2,37
Dromaius novaehollandiae,16711,13,22,2,37
Struthio camelus,16595,13,22,2,37
Anas platyrhynchos,16604,13,22,2,37
Cygnus atratus,16748,13,22,2,37
Columba livia,17229,13,22,2,37
Falco peregrinus,18068,13,22,2,37
Phasianus colchicus,16692,13,22,2,37
Ornithorhynchus anatinus,17019,13,22,2,37
Dasypus novemcinctus,17056,13,22,2,37
Erinaceus europaeus,17447,13,22,2,37
Echinops telfairi,16549,13,22,2,37
Rousettus aegyptiacus,16706,13,22,2,37
Macaca fascicularis,16575,13,22,2,37
Macaca mulatta,16564,13,22,2,37
Gorilla gorilla gorilla,16412,13,22,2,37
Pan paniscus,16563,13,22,2,37
Pan troglodytes,16554,13,22,2,37
Pongo abelii,16499,13,22,2,37
Canis lupus familiaris,16727,13,22,2,37
Ursus arctos,17020,13,22,2,37
Ailuropoda melanoleuca,16805,13,22,2,37
Felis catus,17009,13,22,2,37
Panthera pardus,16964,13,22,2,37
Panthera tigris,16990,13,22,2,37
Puma concolor,17153,13,22,2,37
Phoca vitulina,16826,13,22,2,37
Tursiops truncatus,16388,13,22,2,37
Physeter catodon,16428,13,22,2,37
Balaenoptera acutorostrata,16417,13,22,2,37
Loxodonta africana,16866,13,22,2,37
Equus asinus,16670,13,22,2,37
Equus caballus,16660,13,22,2,37
Ceratotherium simum,16832,13,22,2,37
Orycteropus afer,16816,13,22,2,37
Sus scrofa,16613,13,22,2,37
Camelus bactrianus,16659,13,22,2,37
Camelus dromedarius,16643,13,22,2,37
Odocoileus virginianus,16477,13,22,2,37
Bison bison,16319,13,22,2,37
Bos taurus,16338,13,22,2,37
Bos indicus,16341,13,22,2,37
Capra hircus,16643,13,22,2,37
Ovis aries,16616,13,22,2,37
Ochotona princeps,16481,13,22,2,37
Oryctolagus cuniculus,17245,13,22,2,37
Cricetulus griseus,16284,13,22,2,37
Mesocricetus auratus,16264,13,22,2,37
Rattus rattus,16305,13,22,2,37
Heterocephalus glaber,16386,13,22,2,37
Saccoglossus kowalevskii,17037,13,22,2,37
Monodelphis domestica,17079,13,22,2,37
Solenopsis invicta,15549,13,22,2,37
Bactrocera dorsalis,15915,13,22,2,37
Erpetoichthys calabaricus,16674,13,22,2,37
Zeugodacus cucurbitae,15825,13,22,2,37
Helicoverpa armigera,15347,13,22,2,37
Ursus maritimus,17017,13,22,2,37
Vombatus ursinus,16996,13,22,2,37
Chanos chanos,16231,13,22,2,37
Bos grunniens,16323,13,22,2,37
Vicugna pacos,16652,13,22,2,37
Takifugu rubripes,16447,13,22,2,37
Tetranychus urticae,13103,13,22,2,37
Neolamprologus brichardi,16587,13,22,2,37
Acinonyx jubatus,17047,13,22,2,37
Galendromus occidentalis,24961,21,30,2,53
Enhydra lutris,16431,13,22,2,37
Callorhinus ursinus,16668,13,22,2,37
Eumetopias jubatus,16638,13,22,2,37
Trachemys scripta,16810,13,22,2,37
Kryptolebias marmoratus,17329,13,22,2,37
Gavia stellata,17573,13,22,2,37
Priapulus caudatus,14919,13,22,2,37
Phascolarctos cinereus,16357,13,22,2,37
Seriola dumerili,16530,13,22,2,37
Phoenix dactylifera,715001,43,18,3,64
Pygocentrus nattereri,16706,13,22,2,37
Monopterus albus,16622,13,22,2,37
Pocillopora damicornis,17415,13,2,2,17
Oreochromis aureus,16628,13,22,2,37
Orbicella faveolata,16138,13,2,2,17
Stylophora pistillata,17177,13,3,2,18
Jaculus jaculus,16546,13,22,2,37
Scophthalmus maximus,17583,13,22,2,37
Taeniopygia guttata,16853,13,22,2,37
Chlorocebus sabaeus,16550,13,22,2,37
Rhinopithecus bieti,16551,13,22,2,37
Rhinopithecus roxellana,16549,13,22,2,37
Odobenus rosmarus rosmarus,16565,13,22,2,37
Podarcis muralis,17311,13,22,2,37
Pieris rapae,15157,13,22,2,37
Oncorhynchus tshawytscha,16644,13,22,2,37
Sinocyclocheilus grahami,16585,13,22,2,37
Amphiprion ocellaris,16649,13,22,2,37
Coturnix japonica,16697,13,22,2,37
Gavialis gangeticus,17185,13,22,2,37
Bactrocera oleae,15815,13,22,2,37
Nothobranchius furzeri,19527,13,23,2,38
Varroa destructor,16476,13,22,2,37
Scleropages formosus,16651,13,22,2,37
Lipotes vexillifer,16392,13,22,2,37
Nipponia nippon,16732,13,22,2,37
Acanthaster planci,16234,13,22,2,37
Carassius langsdorfii,16578,13,22,2,37
Boleophthalmus pectinirostris,17111,13,22,2,37
Dendronephthya gigantea,18842,14,1,2,17
Pseudopodoces humilis,16809,13,22,2,37
Chrysochloris asiatica,16652,13,22,2,37
Rhinatrema bivittatum,16422,13,22,2,37
Cephus cinctus,19339,13,22,2,37
Larimichthys crocea,16466,13,22,2,37
Anoplophora glabripennis,15774,13,22,2,37
Cynoglossus semilaevis,16731,13,22,2,37
Halyomorpha halys,16518,13,22,2,37
Seriola lalandi,16532,13,22,2,37
Epinephelus lanceolatus,16574,13,22,2,37
Bubalus carabanensis,16359,13,22,2,37
Propithecus coquereli,17104,13,22,2,37
Amphimedon queenslandica,19960,13,17,2,32
Camelus ferus,16680,13,22,2,37
Galeopterus variegatus,16748,13,22,2,37
Tachysurus fulvidraco,16527,13,22,2,37
Carlito syrichta,17004,13,22,2,37
Diadumene lineata,17552,14,2,2,18
Mercenaria mercenaria,18365,13,22,2,37
Dosinia troscheli,17229,13,22,2,37
Dosinia altior,17536,13,22,2,37
Paraleonnates uschakovi,15540,13,22,2,37
Phytophthora palmivora,40799,39,25,2,66
Purpureocillium lilacinum,23495,15,22,2,39
Erysiphe pisi,188623,84,25,2,111
Monilinia fructicola,159648,67,32,2,101
Erysiphe necator,188577,79,25,2,106
Corynespora cassiicola,40752,15,27,2,44
Aegiceras corniculatum,425282,38,23,3,64
Golovinomyces cichoracearum,332165,30,26,2,58
Bruguiera sexangula,303026,37,20,3,60
Phytophthora heveae,37150,39,25,2,66
Bougainvillea spectabilis,343746,40,24,3,67
Bruguiera x rhynchopetala,286503,35,20,3,58
Chrysopogon zizanioides,551622,76,19,6,101
Lessonia flavicans,37226,38,24,3,65
Pseudo-nitzschia micropora,38792,37,24,2,63
Pseudo-nitzschia cuspidata,37203,37,24,2,63
Clavaria fumosa,256807,121,38,2,161
Ceratocystis polychroma,161224,14,30,2,46
Laminaria solidungula,37862,36,24,2,62
Phytophthora fallax,43681,39,29,2,70
Phytophthora captiosa,44662,39,34,2,75
Thalassiosira profunda,40470,36,25,2,63
Ceratocystis colombiana,131365,14,30,2,46
Ceratocystis papillata,121288,14,30,2,46
Odontella regia,37617,36,24,3,63
Phytophthora agathidicida,36826,39,25,2,66
Phytophthora cocois,37078,39,25,2,66
Phytophthora castaneae,37083,39,25,2,66
Ceratocystis huliohia,155141,14,30,2,46
Ceratocystis lukuohia,144435,14,30,2,46
Ceratocystis uchidae,159132,14,30,2,46
Ceratocystis changhui,177592,14,30,2,46
Diacronema viridis,29282,20,24,3,47
Euplotes vanleeuwenhoeki,41682,39,7,2,48
Caenorhabditis elegans,13794,12,22,2,36
Hepatozoon catesbianae,6394,3,0,25,28
Mustela lutreola,16504,13,22,2,37
Herpestes ichneumon,16775,13,22,2,37
Hyalomma marginatum,14764,13,22,2,37
Haliotis ovina,16531,13,22,2,37
Cercopithecus neglectus,16490,13,22,2,37
Antechinus flavipes,17381,13,22,2,37
Phalanger orientalis,15860,13,22,2,37
Percina copelandi,16607,13,22,2,37
Percina evides,16572,13,22,2,37
Etheostoma blennioides,16639,13,22,2,37
Etheostoma camurum,16639,13,22,2,37
Etheostoma zonale,16586,13,22,2,37
Trachypithecus phayrei,16549,13,22,2,37
Anopheles vaneedeni,15353,13,22,2,37
Brevicoryne brassicae,15927,13,23,2,38
Thymallus arcticus,16661,13,22,2,37
Anopheles rivulorum,15361,13,22,2,37
Xenocypris fangi,16619,13,22,2,37
Sebastiscus albofasciatus,17056,13,22,2,37
Alectryonella plicatula,18225,12,25,3,40
Sabella spallanzanii,15581,13,22,2,37
Ostrinia furnacalis,15241,13,22,2,37
Heniochus acuminatus,16584,13,22,2,37
Darevskia valentini,17393,13,22,2,37
Lycorma meliae,16019,13,22,2,37
Etheostoma tippecanoe,16599,13,22,2,37
Anopheles parensis,15355,13,22,2,37
Terapon theraps,16587,13,22,2,37
Percina macrocephala,16591,13,22,2,37
Percina peltata,16624,13,22,2,37
Trachypithecus geei,16521,13,22,2,37
Pluvialis squatarola,16860,13,22,2,37
Pantala flavescens,14853,13,22,2,37
Jynx torquilla,16832,13,22,2,37
Myotis ricketti,17098,13,22,2,37
Pelopidas mathias,15524,13,22,2,37
Stichopus chloronotus,16247,13,22,2,37
Carpiodes cyprinus,16610,13,22,2,37
Megabalanus tintinnabulum,15107,13,22,2,37
Dicrurus macrocercus,17056,13,22,2,37
Enteroctopus dofleini,16026,13,22,2,37
Ypthima baldus,15304,13,22,2,37
Thymallus nigrescens,16661,13,22,2,37
Kichulchoia brevifasciata,16646,13,22,2,37
Sinocyclocheilus lingyunensis,16572,13,22,2,37
Sinocyclocheilus longibarbatus,16787,13,22,2,37
Amblyraja hyperborea,16729,13,22,2,37
Proterorhinus semilunaris,16998,13,22,2,37
Tringa stagnatilis,16799,13,22,2,37
Cricetulus sokolovi,16292,13,22,2,37
Scutogyrus longicornis,14241,12,22,2,36
Quasipaa exilispinosa,17046,13,23,2,38
Pseudotolithus typus,16502,13,22,2,37
Mytella strigata,16302,13,23,2,38
Leptodactylus fallax,18669,13,22,2,37
Anopheles longipalpis,15353,13,22,2,37
Platycheirus albimanus,16648,13,22,2,37
Necrodes littoralis,17830,13,22,2,37
Dinaromys bogdanovi,16356,13,22,2,37
Thymallus baicalensis,16662,13,22,2,37
Oreolalax schmidti,18481,13,23,2,38
Trachypithecus laotum,16547,13,22,2,37
Omphalius rusticus,18067,13,23,2,38
Percina bimaculata,16604,13,22,2,37
Thymallus nikolskyi,16661,13,22,2,37
Thymallus svetovidovi,16660,13,22,2,37
Coelioxys fenestrata,17004,13,22,2,37
Cryptotermes havilandi,15559,13,22,2,37
Gunungidia aurantiifasciata,15472,13,22,2,37
Gardineria hawaiiensis,19430,13,2,2,17
Balanus trigonus,15336,13,22,2,37
Opisthotropis guangxiensis,17042,13,22,2,37
Aleyrodes shizuokensis,16687,13,22,2,37
Episoriculus leucops,16838,13,22,2,37
Pseudocrossocheilus tridentis,16606,13,22,2,37
Callista chinensis,19703,13,22,2,37
Diplonevra funebris,15314,13,22,2,37
Diplonevra peregrina,15585,13,22,2,37
Ficus variegata Roding_ 1798,15736,13,22,2,37
Syrphus torvus,16444,13,22,2,37
Homatula pycnolepis,16570,13,22,2,37
Neolissochilus hexastichus,16538,13,22,2,37
Turritopsis lata,15047,13,2,2,17
Parascaptor leucura,16875,13,22,2,37
Oyamia nigribasis,15923,13,22,2,37
Tropidothorax cruciger,15781,13,22,2,37
Euaspis polynesia,17682,13,22,2,37
Tor barakae,16780,13,22,2,37
Popillia mutans,16192,13,22,2,37
Sebastiscus tertius,16910,13,22,2,37
Thymallus aeliani,16657,13,22,2,37
Sogatella kolophon,16708,13,22,2,37
Okenia hiroi,14583,13,22,2,37
Luciobarbus brachycephalus,16603,13,22,2,37
Rana uenoi,17370,13,22,2,37
Trachypithecus mauritius,16554,13,22,2,37
Ostorhinchus fleurieu,16521,13,22,2,37
Gymnocypris firmispinatus,16674,13,22,2,37
Iotaphora admirabilis,16140,13,22,2,37
Moschus cupreus,16354,13,22,2,37
Metaphycus eriococci,15749,13,22,2,37
Phlogotettix monozoneus,15199,13,22,2,37
Apomecyna saltator,14949,13,22,2,37
Diploderma micangshanensis,16467,13,22,2,37
Triplophysa baotianensis,16576,13,22,2,37
Paraconotrochus antarcticus,17562,13,2,2,17
Spirometra theileri,13685,12,22,2,36
Sinopodisma qinlingensis,15843,13,22,2,37
Thymallus brevicephalus,16655,13,22,2,37
Thymallus ligericus,16657,13,22,2,37
Hippocampus nalu,16470,13,22,2,37
Anopheles funestus-like sensu Spillings et al. (2009),15357,13,22,2,37
Eremias dzungarica,19899,13,22,2,37
Friesea propria,15442,13,22,2,37
Downesia tarsata,18557,13,22,2,37
Hamaxiella brunnescens,14956,13,22,2,37
Ophichthys cuchia,16450,13,22,2,37
Laterallus spilonota,17045,13,22,2,37
Silurus grahami,16518,13,22,2,37
Exostoma gaoligongense,16529,13,22,2,37
Periscepsia handlirschi,16929,13,22,2,37
Lycocerus asperipennis,16162,13,22,2,37
Crocidura dongyangjiangensis,16883,13,22,2,37
Amphioplus laevis,16084,13,22,2,37
Eucoleus annulatus,14118,13,22,2,37
Pneumocystis jirovecii,35626,15,25,2,42
Haemaphysalis inermis,14846,13,22,2,37
Brugia malayi,13657,12,22,2,36
Ustilaginoidea virens,98050,0,0,0,0
Marasmius oreades,66224,1,14,0,15
Mirabilis jalapa,267334,40,29,3,72
Agrocybe aegerita,121484,40,36,3,79
Hydatigera taeniaeformis,13822,12,22,2,36
Mizuhopecten yessoensis,20964,12,14,0,26
Sarotherodon galilaeus,16630,13,22,2,37
Acanthopagrus latus,16635,13,22,2,37
Lycodes polaris,16595,13,22,2,37
Gryllodes sigillatus,16369,13,22,2,37
Sardinops sagax,16883,13,22,2,37
Pelagomonas calceolata,39376,37,23,3,63
Crocidura russula,17201,13,0,0,13
Pseudo-nitzschia pungens,40380,38,23,2,63
Citrus maxima,538434,36,21,3,60
Aureoumbra lagunensis,55968,38,22,3,63
Enterobius vermicularis,14003,12,22,2,36
Gryllus veletis,15686,13,22,2,37
Tubastraea micranthus,19085,13,2,2,17
Citrus unshiu,521559,35,21,3,59
Lithodesmium undulatum,37057,36,24,3,63
Carcharhinus limbatus,16705,13,22,2,37
Tenodera angustipennis,15531,13,22,2,37
Oncorhynchus gilae,16654,13,22,2,37
Statilia maculata,15866,13,27,2,42
Bandicota bengalensis,16327,13,22,2,37
Cyprinodon macularius,16500,13,22,2,37
Channichthys rhinoceratus,17408,13,22,2,37
Coprinellus micaceus,65450,14,29,2,45
Lepeophtheirus salmonis,16148,12,22,2,36
Sebastes maliger,16403,13,22,2,37
Anopheles sacharovi,15456,13,22,2,37
Anopheles anthropophagus,15413,13,22,2,37
Niviventer fulvescens,16301,13,22,2,37
Artemia salina,15826,13,22,2,37
Ophiocara porocephala,16529,13,22,2,37
Potamotrygon orbignyi,17449,13,22,2,37
Bipolaris oryzae,124887,22,21,2,45
Azumapecten farreri,20889,11,21,2,34
Liolaemus darwinii,16974,13,22,2,37
Gymnopilus junonius,161145,20,25,2,47
Chaetodon speculum,16513,13,22,2,37
Heniochus chrysostomus,16650,13,22,2,37
Xerocomus impolitus,39362,20,27,2,49
Hediste diversicolor,15904,13,22,2,37
Gryllus lineaticeps,15607,13,22,2,37
Ochotona hyperborea,17063,13,22,2,37
Plectropomus laevis,16774,13,22,2,37
Campanulotes compar,15013,13,22,2,37
Navicula veneta,38897,37,23,2,62
Pseudanodonta complanata,16171,13,22,2,37
Varuna litterata,16247,13,22,2,37
Onchocerca lupi,13766,12,22,2,36
Grapsus albolineatus,15578,13,22,2,37
Hylarana latouchii,17007,13,22,2,37
Apriona germari,14858,13,22,2,37
Amusium pleuronectes,18044,13,22,2,37
Prionurus laticlavius,16531,13,22,2,37
Mycerobas carnipes,16806,13,22,2,37
Meloidogyne graminicola,19589,12,22,2,36
Sinotaia quadrata,17255,13,22,2,37
Epinephelus tauvina,16787,13,22,2,37
Lethocerus indicus,16251,13,22,2,37
Arothron stellatus,16475,13,22,2,37
Ceratina okinawana,15207,13,22,2,37
Hemigymnus melapterus,16527,13,22,2,37
Heterobothrium okamotoi,14642,12,22,2,36
Gongylus gongylodes,15348,13,22,2,37
Sphodromantis viridis,15504,13,22,2,37
Hymenopus coronatus,15677,13,24,2,39
Phyllocrania paradoxa,15702,13,22,2,37
Blarinella griselda,16947,13,22,2,37
Unio mancus,15756,13,22,2,37
Moenkhausia sanctaefilomenae,18437,13,23,2,38
Hybognathus placitus,16709,13,22,2,37
Nitzschia supralitorea,49250,40,24,2,66
Inpaichthys kerri,17032,13,22,2,37
Chthamalus malayensis,15230,13,22,2,37
Cyprinodon pecosensis,16501,13,22,2,37
Cyprinodon bovinus,16500,13,22,2,37
Cyprinodon elegans,16499,13,22,2,37
Heteropriacanthus cruentatus,16506,13,22,2,37
Falco subbuteo,17678,13,22,2,37
Paraglenea fortunei,15496,13,22,2,37
Plautia crossota,16809,13,22,2,37
Anodonta nuttalliana,16015,13,22,2,37
Pangasius sanitwongsei,16536,13,22,2,37
Tylopilus plumbeoviolaceoides,37242,20,25,2,47
Sebastes melanostictus,17038,13,22,2,37
Sebastes norvegicus,16401,13,22,2,37
Pseudocreobotra wahlbergii,14816,13,24,2,39
Turdus ruficollis,16737,13,22,2,37
Lutjanus ophuysenii,16498,13,22,2,37
Leiognathus ruconius,16465,13,22,2,37
Glossogobius aureus,16590,13,22,2,37
Idolomantis diabolica,15678,13,22,2,37
Creobroter apicalis,15603,13,23,2,38
Popa spurca,15714,13,22,2,37
Chelidonichthys spinosus,16511,13,22,2,37
Conwentzia sinica,15153,13,22,2,37
Paralichthys adspersus,17060,13,22,2,37
Myotis petax,17299,13,36,2,51
Oregonia gracilis,15737,13,22,2,37
Actinopyga lecanora,15569,13,22,2,37
Gnathopogon herzensteini,16594,13,22,2,37
Chorthippus parallelus parallelus,15623,13,22,2,37
Chorthippus parallelus erythropus,15624,13,22,2,37
Amegilla calceifera,17728,13,22,2,37
Thyreus decorus,15237,13,22,2,37
Deroplatys desiccata,15305,13,22,2,37
Blepharopsis mendica,15628,13,22,2,37
Eudiscopus denticulus,16597,13,22,2,37
Etheostoma fonticola,16662,13,22,2,37
Dicaeum agile,16809,13,22,2,37
Dicaeum concolor,16796,13,22,2,37
Coscinodiscus wailesii,36071,38,23,2,63
Thayeria boehlkei,16624,13,22,2,37
Pagurus similis,17100,13,22,2,37
Neoraja iberica,16723,13,22,2,37
Taumantis sigiana,15477,13,22,2,37
Parasphendale agrionina,15489,13,22,2,37
Haemagogus spegazzinii,15081,13,22,2,37
Fistulifera saprophila,38896,38,22,2,62
Maxomys ochraceiventer,16293,13,22,2,37
Pasiphila chloerata,15602,13,22,2,37
Tryblionella apiculata,39061,37,24,2,63
Lactoria fornasini,16488,13,22,2,37
Tolypanthus maclurei,256961,38,18,5,61
Moenkhausia costae,15811,13,22,2,37
Schizothorax sinensis,16571,13,22,2,37
Theretra oldenlandiae,15312,13,22,2,37
Chroicocephalus saundersi,16739,13,22,2,37
Haemagogus leucocelaenus,15056,13,22,2,37
Aythya baeri,16623,13,22,2,37
Unio elongatulus,15763,13,22,2,37
Tetraclita kuroshioensis,15175,13,22,2,37
Colasposoma dauricum,15490,13,22,2,37
Seladonia aeraria,15410,13,22,2,37
Ctenochaetus tominiensis,16442,13,22,2,37
Prionurus biafraensis,16552,13,22,2,37
Phrynocephalus maculatus,12631,13,19,1,33
Physosmaragdina nigrifrons,15903,13,22,2,37
Opatrum sabulosum,16079,13,22,2,37
Tubastraea diaphana,19093,13,2,2,17
Melanophila acuminata,15853,13,22,2,37
Tullbergia mixta,14998,13,22,2,37
Sclomina erinacea,15828,13,22,2,37
Ectropis grisescens,15794,13,22,2,37
Heortia vitessoides,15237,13,22,2,37
Acontista multicolor,15630,13,22,2,37
Brunneria borealis,15431,13,22,2,37
Parmaturus melanobranchus,16687,13,22,2,37
Deroplatys lobata,15681,13,22,2,37
Phyllothelys werneri,16361,13,22,2,37
Pseudempusa pinnapavonis,15496,13,22,2,37
Laminaria rodriguezii,38047,37,25,2,64
Pseudovates chlorophaea,16253,13,25,2,40
Argas boueti,14307,13,21,2,36
Compsilura concinnata,15841,13,22,2,37
Lissocarcinus arkati,15510,13,22,2,37
Fieberiella septentrionalis,16175,13,22,2,37
Hylica paradoxa,14762,13,22,2,37
Anodonta exulcerata,15619,13,22,2,37
Acromantis hesione,16179,13,22,2,37
Amorphoscelis chinensis,15805,13,22,2,37
Anaxarcha sinensis,15634,13,22,2,37
Empusa pennicornis,15484,13,22,2,37
Hestiasula hoffmanni,16022,13,23,2,38
Hierodula majuscula,16000,13,22,2,37
Hierodula multispina,16282,13,22,2,37
Idolomorpha lateralis,15604,13,22,2,37
Mesopteryx alata,18075,13,26,2,41
Miomantis caffra,15760,13,22,2,37
Miromantis yunnanensis,15542,13,22,2,37
Orthodera ministralis,15756,13,24,2,39
Pnigomantis medioconstricta,15987,13,22,2,37
Prohierodula picta,15565,13,22,2,37
Tarachomantis alaotrana,15459,13,22,2,37
Theopompa milligratulata,16046,13,27,2,42
Theopropus cattulus,15684,13,24,2,39
Theopropus rubrobrunneus,15577,13,23,2,38
Neodanuria bolauana,15451,13,22,2,37
Parymenopus davisoni,15588,13,23,2,38
Sinomantis denticulata,15832,13,22,2,37
Sinomiopteryx grahami,15978,13,23,2,38
Spilomantis occipitalis,15767,13,23,2,38
Yininemertes pratensis,15616,13,24,2,39
Phanuelus gladstone,14458,13,22,2,37
Pygoluciola qingyu,17332,13,22,2,37
Acropoma japonicum,16973,13,23,2,38
Analcellicampa danfengensis,15968,13,22,2,37
Potamilus streckersoni,16293,14,22,2,38
Dopasia hainanensis,17000,13,22,2,37
Amphinemura bulla,15827,13,22,2,37
Perlesta teaysia,16023,13,22,2,37
Ateuchosaurus chinensis,16840,13,22,2,37
Sinocyclocheilus angularis,16586,13,22,2,37
Exaiptasia diaphana,19790,14,2,2,18
Megabeleses magnoliae,15918,13,22,2,37
Conosia irrorata,14634,13,22,2,37
Megabeleses liriodendrovorax,16019,13,22,2,37
Pseudagkistrodon rudis,19153,13,22,2,37
Kaylathalia klovstadi,15485,13,22,2,37
Liolaemus millcayac,16945,13,22,2,37
Thuricola similis,38802,43,4,2,49
Spirobolus bungii,14879,13,22,2,37
Euphaedusa planostriata,15041,13,22,2,37
Balala fujiana,16221,13,22,2,37
Kalasha nativa,15716,13,22,2,37
Nacolus tuberculatus,15737,13,22,2,37
Aulacochilus grouvellei,15607,13,22,2,37
Haemagogus albomaculatus,15097,13,22,2,37
Haemagogus tropicalis,14917,13,22,2,37
Coreoleuciscus aeruginos,16563,13,22,2,37
Yasuhikotakia splendida,16695,13,22,2,37
Cromileptes altivelis x Epinephelus tukula,16503,13,22,2,37
Tipula nova,15668,13,22,2,37
Phrynocephalus nasatus,16852,13,22,2,37
Amorphoscelis hainana,15792,13,22,2,37
Pygmaeocidaris prionigera,16358,13,22,2,37
Semnopithecus schistaceus,16534,13,22,2,37
Epiphragma mediale,14858,13,22,2,37
Dicraeus orientalis,16188,13,22,2,37
Liolaemus parthenos,16838,13,22,2,37
Paragnetina indentata,15885,13,22,2,37
Sesia siningensis,15454,13,22,2,37
Dausara latiterminalis,15147,13,22,2,37
Pseudonoorda nigropunctalis,15084,13,22,2,37
Aotus azarai azarai,16585,13,22,2,37
Aotus nancymaae,16469,13,22,2,37
Elodia flavipalpis,14932,13,22,2,37
Anoplopoma fimbria,16507,13,22,2,37
Actias selene,15236,13,22,2,37
Ctenopharyngodon idella x Megalobrama amblycephala,16610,13,22,2,37
Dissostichus eleginoides,18704,13,23,2,38
Cucujus clavipes,15642,13,22,2,37
Necrophila americana,16902,13,22,2,37
Elaphurus davidianus,16355,13,22,2,37
Madurella mycetomatis,45590,24,26,2,52
Frankliniella occidentalis,14889,13,22,2,37
Calosoma sp. BYU-CO241,16462,13,22,2,37
Tropisternus sp. BYU-CO166,16372,13,22,2,37
Sphenophorus sp. BYU-CO246,15052,13,21,2,36
Champsocephalus gunnari,18863,14,24,2,40
Baikalospongia intermedia profundalis,28227,14,25,2,41
Aporia crataegi,15140,13,22,2,37
Euspilotus scissus,14763,13,22,2,37
Naupactus xanthographus,15026,13,21,2,36
Membranipora grandicella,15861,13,20,2,35
Kulikovia alborostrata,15476,13,22,2,37
Rezinkovia echinata,28614,14,25,2,41
Madrepora oculata,15841,13,2,2,17
Hemitheconyx caudicinctus,17043,13,22,2,37
Iridona iridescens,16799,12,22,2,36
Hiatula diphos,16352,12,22,2,36
Semele scabra,17117,12,21,2,35
Solecurtus divaricatus,16749,12,22,2,36
Renilla muelleri,18643,14,1,2,17
Sinularia peculiaris,18742,14,1,2,17
Stylatula elongata,18733,14,1,2,17
Puccinia graminis f. sp. tritici CRL 75-36-700-3,79748,0,0,0,0
Schistosoma mekongi,14072,12,22,2,36
Fasciola hepatica,14462,12,22,2,36
Taenia crassiceps,13503,12,22,2,36
Schistosoma japonicum,14085,12,23,2,37
Elephas maximus,16902,13,22,2,37
Metarhizium anisopliae,24673,15,24,2,41
Schistosoma spindale,16901,12,22,2,36
Microtus levis,16283,13,22,2,37
Trichonephila clavata,14436,13,22,2,37
Briareum asbestinum,18632,14,1,2,17
Xenagama taylori,16220,13,22,2,37
Branchiostoma japonicum,15075,13,22,2,37
Hynobius leechii,16428,13,22,2,37
Batrachuperus londongensis,16379,13,22,2,37
Batrachuperus pinchonii,16390,13,22,2,37
Liua shihi,16376,13,22,2,37
Hynobius amjiensis,16401,13,22,2,37
Liua tsinpaensis,16380,13,22,2,37
Hynobius formosanus,16394,13,22,2,37
Salamandrella keyserlingii,16338,13,22,2,37
Pachyhynobius shangchengensis,16394,13,22,2,37
Sigmops gracilis,16436,13,22,2,37
Beta vulgaris subsp. vulgaris,368801,140,26,5,171
Batrachuperus tibetanus,16379,13,22,2,37
Canis lupus,16729,13,22,2,37
Canis latrans,16724,13,22,2,37
Onychodactylus fischeri,16456,13,22,2,37
Hynobius chinensis,16408,13,22,2,37
Paradactylodon persicus,16374,13,22,2,37
Lophiotoma cerithiformis,15380,13,22,2,37
Cyprinella spiloptera,16545,13,22,2,37
Scomberomorus cavalla,16548,13,22,2,37
Micropterus salmoides,16484,13,22,2,37
Notropis stramineus,16711,13,22,2,37
Lepisosteus osseus,16328,13,22,2,37
Campostoma anomalum,16654,13,22,2,37
Gila robusta,16595,13,22,2,37
Phenacobius mirabilis,16884,13,22,2,37
Iberochondrostoma lemmingii,16601,13,22,2,37
Minytrema melanops,16627,13,22,2,37
Percina macrolepida,16602,13,22,2,37
Dorosoma cepedianum,16704,13,22,2,37
Lophiomus setigerus,15879,13,22,2,37
Petaurus breviceps,16103,13,22,2,37
Distoechurus pennatus,16775,13,22,2,37
Dactylopsila trivirgata,16058,13,22,2,37
Pelobates cultripes,17384,13,22,2,37
Lagorchestes hirsutus,16889,13,22,2,37
Eudyptes chrysocome,16930,13,22,2,37
Gavia pacifica,15574,13,22,2,37
Adoxophyes honmai,15680,13,22,2,37
Diretmus argenteus,16070,13,22,2,37
Sirembo imberbis,16090,13,22,2,37
Diretmoides veriginae,16120,13,22,2,37
Anomalops katoptron,15980,13,22,2,37
Aptocyclus ventricosus,15974,13,22,2,37
Aspasma minima,17487,13,22,2,37
Podiceps cristatus,16134,12,21,2,35
Phalanger vestitus,15318,13,20,2,35
Crocodylus niloticus,16830,13,22,2,37
Paradactylodon mustersi,16383,13,22,2,37
Galemys pyrenaicus,16510,13,22,2,37
Antillogorgia bipinnata,18733,14,1,2,17
Nematostella sp. JVK-2006,16389,13,2,2,17
Flustrellidra hispida,13026,13,21,2,36
Nasalis larvatus,16570,13,22,2,37
Pygathrix nemaeus,15467,13,22,2,37
Presbytis melalophos,16543,13,22,2,37
Semnopithecus entellus,16532,13,22,2,37
Piliocolobus badius,16595,13,22,2,37
Trachyrincus murrayi,16677,13,22,2,37
Bathygadus antrodes,17596,13,23,2,38
Squalogadus modificatus,16550,13,22,2,37
Ventrifossa garmani,17230,13,22,2,37
Liobagrus obesus,16531,13,22,2,37
Campodea fragilis,14965,13,22,2,37
Campodea lubbocki,14974,13,22,2,37
Agamermis sp. BH-2006,16561,12,26,2,40
Nephroselmis olivacea,45223,40,26,3,69
Mesostigma viride,42424,41,26,3,70
Verticillium dahliae,27184,15,25,2,42
Cranoglanis bouderius,16539,13,22,2,37
Triatoma dimidiata,17019,13,22,2,37
Plasmodium juxtanucleare,6014,3,0,15,18
Aspergillus oryzae,29202,0,25,0,25
Brassica napus,221853,79,17,3,99
Ostreococcus tauri,44237,43,28,6,77
Pteropus dasymallus,16705,13,22,2,37
Solea senegalensis,16659,13,22,2,37
Biwia zezera,16599,13,22,2,37
Lacerta viridis viridis,17156,13,22,2,37
Zea perennis,570354,32,17,3,52
Zea luxurians,539368,32,17,3,52
Zea mays subsp. parviglumis,680603,42,16,3,61
Tetrahymena malaccensis,47691,45,8,6,59
Tetrahymena paravorax,47496,44,8,6,58
Tetrahymena pigmentosa,46990,44,8,6,58
Aspergillus terreus NIH2624,32827,0,0,0,0
Pedinomonas minor,25137,11,9,3,23
Wickerhamomyces canadensis,27694,18,25,2,45
Naegleria gruberi,49843,46,21,2,69
Physarum polycephalum,62862,20,0,0,20
Plasmodium reichenowi,5966,3,0,0,3
Tetrahymena pyriformis,47296,44,8,6,58
Cafeteria roenbergensis,43159,34,22,2,58
Synura synuroidea,34119,37,23,2,62
Rhodomonas salina,48063,44,27,2,73
Malawimonas jakobiformis,47328,49,36,4,89
Chlamydomonas reinhardtii,15758,8,3,14,25
Leishmania tarentolae,20992,2,0,2,4
Prototheca wickerhamii,55328,36,26,3,65
Sorghum bicolor,468628,32,18,3,53
Tripsacum dactyloides,704100,33,18,3,54
Ustilago maydis,56814,26,23,2,51
Sardinops melanostictus,16881,13,22,2,37
Vulpes vulpes,16813,13,22,2,37
Zalophus californianus,16677,13,22,2,37
Leptonychotes weddellii,16603,13,22,2,37
Mirounga leonina,16970,13,22,2,37
Pusa hispida,16754,13,22,2,37
Pusa sibirica,16773,13,22,2,37
Hydrurga leptonyx,16602,13,22,2,37
Neomonachus schauinslandi,16754,13,22,2,37
Bufo gargarizans,17277,13,22,2,37
Phocarctos hookeri,16722,13,22,2,37
Arctocephalus pusillus,16652,13,22,2,37
Phoca fasciata,16694,13,22,2,37
Phoca groenlandica,16551,13,22,2,37
Phoca largha,16701,13,22,2,37
Cystophora cristata,16952,13,22,2,37
Erignathus barbatus,16705,13,22,2,37
Lobodon carcinophaga,16759,13,22,2,37
Arctocephalus townsendi,16571,13,22,2,37
Neophoca cinerea,16736,13,22,2,37
Pusa caspica,16737,13,22,2,37
Chrysopathes formosa,18398,13,2,2,17
Halocaridina rubra,16065,13,22,2,37
Aurelia aurita,16937,15,2,2,19
Thunnus orientalis,16527,13,22,2,37
Neofelis nebulosa,16844,13,22,2,37
Galaxiella nigrostriata,19017,13,22,2,37
Acanthocardia tuberculata,16104,12,23,2,37
Scutigerella causeyae,14637,13,22,2,37
Lagostrophus fasciatus,16866,13,22,2,37
Cervus nippon taiouanus,16436,13,22,2,37
Verasper moseri,17588,13,22,2,37
Pteropus scapulatus,16741,13,22,2,37
Chalinolobus tuberculatus,16818,13,22,2,37
Chaetomium globosum CBS 148.51,258733,0,0,0,0
Chaetomium globosum CBS 148.51,140602,0,0,0,0
Chaetomium globosum CBS 148.51,50760,0,0,0,0
Chaetomium globosum CBS 148.51,36141,0,0,0,0
Chaetomium globosum CBS 148.51,30759,0,0,0,0
Chaetomium globosum CBS 148.51,16054,0,0,0,0
Chaetomium globosum CBS 148.51,11320,0,0,0,0
Chaetomium globosum CBS 148.51,10846,0,0,0,0
Chaetomium globosum CBS 148.51,9058,0,0,0,0
Chaetomium globosum CBS 148.51,8045,0,0,0,0
Chaetomium globosum CBS 148.51,7290,0,0,0,0
Chaetomium globosum CBS 148.51,7166,0,0,0,0
Chaetomium globosum CBS 148.51,6862,0,0,0,0
Chaetomium globosum CBS 148.51,6834,0,0,0,0
Chaetomium globosum CBS 148.51,5637,0,0,0,0
Chaetomium globosum CBS 148.51,4347,0,0,0,0
Muntiacus reevesi micrurus,16353,13,22,2,37
Heterorhabditis bacteriophora,18128,12,22,2,36
Apus apus,17037,13,22,2,37
Dryocopus pileatus,16832,13,22,2,37
Pandion haliaetus,17864,13,22,2,37
Micrastur gilvicollis,17344,13,22,2,37
Falco sparverius,17507,13,22,2,37
Ardea novaehollandiae,17511,13,22,2,37
Pteroglossus azara flavirostris,18736,13,22,2,37
Xenoturbella bocki,15234,13,22,2,37
Nymphon gracile,14681,13,22,2,37
Lithobius forficatus,15695,13,22,2,37
Parargyrops edita,16640,13,22,2,37
Catostomus commersonii,16625,13,22,2,37
Romanomermis culicivorax,26194,14,32,2,48
Gobio gobio,16607,13,22,2,37
Tinca tinca,16612,13,22,2,37
Cyprinella lutrensis,16706,13,22,2,37
Notemigonus crysoleucas,16583,13,22,2,37
Opsariichthys uncirostris,16613,13,22,2,37
Barbus barbus,16600,13,22,2,37
Alburnus alburnus,16605,13,22,2,37
Hypentelium nigricans,16625,13,22,2,37
Xenocypris argentea,16629,13,22,2,37
Gymnocypris przewalskii,16682,13,22,2,37
Acheilognathus typus,16778,13,22,2,37
Hemibarbus barbus,16681,13,22,2,37
Rhodeus ocellatus kurumeus,16674,13,22,2,37
Pseudorasbora pumila,16601,13,22,2,37
Pungtungia herzi,16600,13,22,2,37
Enteromius trimaculatus,16417,13,22,2,37
Aphyocypris chinensis,16606,13,22,2,37
Chromobotia macracanthus,16937,13,22,2,37
Cycleptus elongatus,16626,13,22,2,37
Gyrinocheilus aymonieri,16609,13,22,2,37
Ischikauia steenackeri,16620,13,22,2,37
Chanodichthys mongolicus,16622,13,22,2,37
Labeo senegalensis,16604,13,22,2,37
Pethia ticto,17302,13,22,2,37
Pseudaspius leptocephalus,16604,13,22,2,37
Tribolodon nakamurai,16616,13,22,2,37
Pelecus cultratus,16610,13,22,2,37
Nipponocypris sieboldii,16616,13,22,2,37
Gnathopogon elongatus,16604,13,22,2,37
Labeo batesii,16603,13,22,2,37
Esomus metallicus,17029,13,22,2,37
Acantopsis choirorhynchos,16600,13,22,2,37
Barbatula toni,16617,13,22,2,37
Pseudohomaloptera leonardi,16580,13,22,2,37
Pangio anguillaris,16602,13,22,2,37
Leptobotia mantschurica,16588,13,21,2,36
Misgurnus nikolskyi,16570,13,22,2,37
Schistura balteata,16564,13,22,2,37
Vaillantella maassi,17296,13,21,2,36
Rhynchocypris percnurus mantschuricus,16602,13,22,2,37
Barbonymus gonionotus,16580,13,22,2,37
Romanomermis nielseni,15546,12,25,2,39
Romanomermis iyengari,18919,13,25,2,40
Oncorhynchus masou ishikawae,16652,13,22,2,37
Oncorhynchus masou masou,16652,13,21,2,36
Elaphodus cephalophus,16347,13,22,2,37
Opsariichthys bidens,16611,13,22,2,37
Oncorhynchus masou formosanus,16652,13,22,2,37
Capitulum mitella,14915,13,22,2,37
Gymnogobius petschiliensis,16424,13,22,2,37
Myxine glutinosa,18909,13,22,2,37
Ursus thibetanus mupinensis,16868,13,22,2,37
Simosyrphus grandicornis,16141,13,22,2,37
Trichophthalma punctata,16396,13,21,2,36
Cydistomyia duplonotata,16247,13,23,2,38
Coleonyx variegatus,17110,13,22,2,37
Lepidophyma flavimaculatum,16158,13,22,2,37
Gekko vittatus,16946,13,22,2,37
Heloderma suspectum,16846,13,22,2,37
Furcifer oustaleti,18021,13,22,2,37
Coregonus lavaretus,16737,13,22,2,37
Polymixia japonica,16481,13,22,2,37
Diplophos taenia,16418,13,22,2,37
Conus textile,15562,13,22,2,37
Crocodylus siamensis,16836,13,22,2,37
Gyrodactylus salaris,14790,12,22,2,36
Mammuthus primigenius,16770,13,22,2,37
Thalassarche melanophris,18967,14,25,2,41
Hexamermis agrotis,24606,14,24,2,40
Phacochoerus africanus,16719,13,22,2,37
Dibothriocephalus latus,13608,12,22,2,36
Tropheus duboisi,16598,13,22,2,37
Astronotus ocellatus,16569,13,22,2,37
Cymatogaster aggregata,16533,13,22,2,37
Ditrema temminckii,16572,13,22,2,37
Pseudolabrus sieboldi,16510,13,22,2,37
Abudefduf vaigiensis,16703,13,22,2,37
Halichoeres melanurus,17045,13,22,2,37
Olisthops cyanomelas,16632,13,22,2,37
Anomalurus sp. GP-2005,16923,13,22,2,37
Oreochromis sp. KM-2006,16626,13,22,2,37
Epiperipatus biolleyi,14411,13,13,2,28
Thryonomys swinderianus,16626,13,22,2,37
Cochliomyia hominivorax,16022,13,22,2,37
Yarrowia lipolytica,47916,24,27,2,53
Hime japonica,16653,13,22,2,37
Dinornis giganteus,17070,13,22,2,37
Emeus crassus,17061,13,22,2,37
Procyon lotor,16623,13,22,2,37
Trichinella spiralis,16706,13,22,2,37
Conger myriaster,18705,13,22,2,37
Cyanidioschyzon merolae,32211,34,25,3,62
Plecoglossus altivelis,16542,13,22,2,37
Melopsittacus undulatus,18193,13,22,2,37
Cyprinodon rubrofluviatilis,16501,13,22,2,37
Bombina variegata,18551,13,22,2,37
Macrochelys temminckii,16569,13,22,2,37
Pelophylax plancyi,17822,13,22,2,37
Oncorhynchus masou 'Biwa',16652,13,23,2,38
Chrysomya putoria,15837,13,23,2,38
Tetrodontophora bielanensis,15455,13,22,2,37
Isoodon macrourus,16852,13,22,2,37
Mauremys mutica,16609,13,22,2,37
Ursus thibetanus formosanus,17044,13,22,2,37
Hynobius arisanensis,16401,13,22,2,37
Nycticebus coucang,16764,13,22,2,37
Cebus albifrons,16554,13,22,2,37
Macaca sylvanus,16586,13,22,2,37
Hymenolepis diminuta,13900,12,22,2,36
Leucocytozoon sabrazesi,5935,3,0,0,3
Anomalopteryx didiformis,16716,13,22,2,37
Dogania subplana,17289,13,22,2,37
Caiman crocodilus,17900,13,22,2,37
Iguana iguana,16633,13,22,2,37
Pelophylax nigromaculatus,17804,13,22,2,37
Eptatretus burgeri,17168,13,22,2,37
Echinosorex gymnura,17088,13,22,2,37
Phytophthora sojae,42977,47,25,2,74
Phytophthora ramorum,39314,43,26,2,71
Chlamydosaurus kingii,16761,13,22,2,37
Cephalopachus bancanus,16927,13,22,2,37
Trachurus japonicus,16559,13,22,2,37
Arctoscopus japonicus,16577,13,22,2,37
Microhyla ornata,16730,13,22,2,37
Odorrana tormota,17962,13,22,2,37
Echinococcus oligarthrus,13791,12,22,2,36
Echinococcus vogeli,13750,12,22,2,36
Dibothriocephalus nihonkaiensis,13747,12,22,2,36
Echinococcus shiquicus,13807,12,22,2,36
Reticulitermes flavipes,16565,13,22,2,37
Reticulitermes virginicus,16513,13,22,2,37
Reticulitermes hageni,16590,13,22,2,37
Pagellus bogaraveo,16941,13,22,2,37
Reticulitermes santonensis,16567,13,22,2,37
Ammotragus lervia,16530,13,22,2,37
Sardina pilchardus,16822,13,22,2,37
Clupea pallasii,16700,13,22,2,37
Alosa pseudoharengus,16646,13,22,2,37
Engraulis encrasicolus,16674,13,22,2,37
Sardinella maderensis,16651,13,22,2,37
Sprattus sprattus,16668,13,22,2,37
Dorosoma petenense,16792,13,22,2,37
Etrumeus teres,16979,13,22,2,37
Siganus fuscescens,16491,13,22,2,37
Alosa alosa,16698,13,22,2,37
Ethmalosa fimbriata,16898,13,22,2,37
Spratelloides gracilis,16686,13,22,2,37
Ilisha elongata,16809,13,22,2,37
Coilia nasus,16897,13,22,2,37
Ilisha africana,16642,13,22,2,37
Nematalosa japonica,16655,13,22,2,37
Spratelloides delicatulus,16617,13,22,2,37
Odaxothrissa vittata,16733,13,22,2,37
Pellonula leonensis,16736,13,22,2,37
Lodderomyces elongisporus NRRL YB-4239,35601,0,0,0,0
Perionyx excavatus,15083,13,21,2,36
Chlorokybus atmophyticus,201763,58,28,3,89
Vanderwaltozyma polyspora,21684,9,23,0,32
Ochotona collaris,16968,13,22,2,37
Trichosurus vulpecula,17191,13,22,2,37
Episoriculus fumidus,17488,13,22,2,37
Microtus kikuchii,16312,13,22,2,37
Schizophyllum commune,49704,20,27,2,49
Hyaloraphidium curvatum,29593,18,7,3,28
Rhizophydium sp. 136,68834,37,7,2,46
Spizellomyces punctatus,58830,31,8,2,41
Pylaiella littoralis,58507,52,23,3,78
Spizellomyces punctatus,1136,0,0,0,0
Spizellomyces punctatus,1381,1,0,0,1
Argopecten irradians,16221,12,22,2,36
Sepia esculenta,16199,13,22,2,37
Martes melampus,16498,13,22,2,37
Calotes versicolor,16670,13,22,2,37
Gulo gulo,16541,13,22,2,37
Vampyroteuthis infernalis,15617,13,22,2,37
Penaeus chinensis,16004,13,22,2,37
Trichobilharzia regenti,14838,12,22,2,36
Meles anakuma,16492,13,22,2,37
Ailurus fulgens styani,16374,13,22,2,37
Canis lupus lupus,16757,13,22,2,37
Terebratalia transversa,14291,13,22,2,37
Hippoglossus hippoglossus,17546,13,22,2,37
Reinhardtius hippoglossoides,18017,13,22,2,37
Hippoglossus stenolepis,17841,13,22,2,37
Pantodon buchholzi,15845,13,22,2,37
Engraulis japonicus,16675,13,22,2,37
Osteoglossum bicirrhosum,16006,13,22,2,37
Paleosuchus palpebrosus,14935,13,19,2,34
Osteolaemus tetraspis,16814,13,22,2,37
Dosidicus gigas,20324,18,23,2,43
Paleosuchus trigonatus,15948,13,22,2,37
Egretta eulophotes,17579,13,22,2,37
Mesobuthus martensii,15034,13,21,2,36
Chlorocebus pygerythrus,16343,13,22,2,37
Chlorocebus tantalus,16368,13,22,2,37
Parastagonospora nodorum SN15,49761,19,27,2,48
Anarhichas lupus,16516,13,22,2,37
Bactrocera carambolae,15915,13,22,2,37
Asymmetron inferum,15084,13,22,2,37
Asymmetron sp. A TK-2007,15050,13,22,2,37
Pantherophis slowinskii,17189,13,23,2,38
Pocillopora grandis,17422,13,2,2,17
Phallusia mammillata,14579,13,23,2,38
Phallusia fumigata,15535,13,26,2,41
Luvarus imperialis,16497,13,22,2,37
Zanclus cornutus,16521,13,22,2,37
Spicara maena,16638,13,22,2,37
Centropyge loriculus,16509,13,22,2,37
Zebrasoma flavescens,16503,13,22,2,37
Lethrinus obsoletus,16779,13,22,2,37
Coreoperca kawamebari,16488,13,22,2,37
Lutjanus rivulatus,16511,13,22,2,37
Chaetodon auripes,16530,13,22,2,37
Heniochus diphreutes,16772,13,22,2,37
Chaetodontoplus septentrionalis,16833,13,22,2,37
Doederleinia berycoides,16523,13,22,2,37
Diodon holocanthus,16514,13,22,2,37
Naso lopezi,16542,13,22,2,37
Diagramma picta,16530,13,22,2,37
Trixiphichthys weberi,16332,13,22,2,37
Triodon macropterus,16507,13,22,2,37
Monodactylus argenteus,16542,13,22,2,37
Parapristipoma trilineatum,16546,13,22,2,37
Triacanthus biaculeatus,16565,13,22,2,37
Kentrocapros aculeatus,16485,13,22,2,37
Ostracion immaculatus,16502,13,22,2,37
Ruspolia dubia,14971,13,22,2,37
Tilletia indica,65147,14,24,2,40
Caenorhabditis briggsae,14420,12,22,2,36
Bufo japonicus,17757,13,22,2,37
Taenia saginata,13670,12,22,2,36
Strongylocentrotus pallidus,15712,13,22,2,37
Strongylocentrotus droebachiensis,15717,13,22,2,37
Stylephorus chordatus,15894,13,22,2,37
Pyrophorus divergens,16120,13,22,2,37
Helarctos malayanus,16783,13,22,2,37
Melursus ursinus,16817,13,22,2,37
Tremarctos ornatus,16766,13,22,2,37
Anabrus simplex,15766,13,22,2,37
Ursus thibetanus,16795,13,22,2,37
Pseudocellus pearsei,15099,13,22,2,37
Nothopuga sp. 1 LP-2008,14985,13,22,2,37
Heterodontus francisci,16708,13,22,2,37
Chimaera monstrosa,18580,13,22,2,37
Salmo trutta trutta,16677,13,22,2,37
Rhynochetos jubatus,16937,13,22,2,37
Archilochus colubris,16356,13,22,2,37
Reishia clavigera,15285,13,22,2,37
Tachybaptus novaehollandiae,18002,13,22,2,37
Phoenicopterus roseus,17446,13,22,2,37
Porphyrio hochstetteri,16988,13,22,2,37
Puntigrus tetrazona,16550,13,22,2,37
Boreogadus saida,16745,13,22,2,37
Arctogadus glacialis,16644,13,22,2,37
Antheraea pernyi,15566,13,22,2,37
Duttaphrynus melanostictus,17374,13,22,2,37
Hypophthalmichthys molitrix,16620,13,22,2,37
Buteo buteo,18674,13,22,2,37
Myripristis berndti,16531,13,22,2,37
Mugil cephalus,16685,13,22,2,37
Zeus faber,16715,13,22,2,37
Chauliodus sloani,17814,13,22,2,37
Elassoma evergladei,15780,13,22,2,37
Lampris guttatus,15598,13,21,2,36
Beryx splendens,16529,13,22,2,37
Rondeletia loricata,16530,13,22,2,37
Zenopsis nebulosus,16065,13,22,2,37
Cololabis saira,16499,13,22,2,37
Ateleopus japonicus,16650,13,22,2,37
Ijimaia dofleini,16645,13,22,2,37
Chlorophthalmus agassizi,16221,13,22,2,37
Harpadon microchir,16061,13,22,2,37
Saurida undosquamis,15737,13,22,2,37
Myctophum affine,16239,13,22,2,37
Diaphus splendidus,15985,13,21,2,36
Zu cristatus,15987,13,22,2,37
Polymixia lowei,16473,13,22,2,37
Percopsis transmontana,16079,13,22,2,37
Coelorinchus kishinouyei,15942,13,22,2,37
Exocoetus volitans,16527,13,22,2,37
Poromitra oscitans,16387,13,22,2,37
Danacetichthys galathenus,16555,13,22,2,37
Hoplostethus japonicus,16528,13,22,2,37
Antigonia capros,16508,13,22,2,37
Mastacembelus favus,16498,13,22,2,37
Dactyloptena peterseni,16717,13,22,2,37
Helicolenus hilgendorfi,16728,13,22,2,37
Kareius bicoloratus,15973,13,22,2,37
Stephanolepis cirrhifer,16306,13,22,2,37
Pagrus major,17031,13,22,2,37
Trachipterus trachypterus,16162,13,22,2,37
Negombata magnifica,20088,14,25,2,41
Hypophthalmichthys nobilis,16621,13,22,2,37
Ephydatia muelleri,23929,14,25,2,41
Hydra oligactis,16314,13,2,2,17
Bugula neritina,15433,13,23,2,38
Naja naja,17213,13,22,2,37
Deinagkistrodon acutus,17548,13,22,2,37
Hypsiscopus plumbea,17397,13,22,2,37
Indotyphlops braminus,16397,13,22,2,37
Biomphalaria tenagophila,13722,13,22,2,37
Hynobius quelpaertensis,16407,13,22,2,37
Oxya chinensis,15443,13,22,2,37
Amphimedon compressa,18564,14,24,2,40
Callyspongia plicifera,18846,14,24,2,40
Xestospongia muta,18990,14,25,2,41
Halisarca dujardinii,19277,14,25,2,41
Topsentia ophiraphidites,19763,14,25,2,41
Iotrochota birotulata,19112,14,24,2,40
Aplysina fulva,19620,14,25,2,41
Plakinastrella cf. onkodes DVL-2011,19790,15,6,2,23
Odontobutis platycephala,17588,13,22,2,37
Agelas schmidtii,20360,14,24,2,40
Antrokoreana gracilipes,14747,13,23,2,38
Cinachyrella kuekenthali,18089,14,24,2,40
Ectyoplasia ferox,18312,14,25,2,41
Chondrilla aff. nucula CHOND,19282,14,25,2,41
Hippospongia lachne,16755,14,2,2,18
Ptilocaulis walpersi,18865,14,25,2,41
Vaceletia sp. GW948,20658,14,2,2,18
Igernella notabilis,20310,14,2,2,18
Zymoseptoria tritici,43964,22,27,2,51
Sylvia atricapilla,17937,13,22,2,37
Acrocephalus scirpaceus,17903,13,22,2,37
Sylvia crassirostris,17207,13,22,2,37
Xyrauchen texanus,16634,13,22,2,37
Microhyla okinavensis,16717,13,22,2,37
Hippocampus kuda,16527,13,22,2,37
Aulostomus chinensis,18154,13,22,2,37
Oostethus brachyurus,16545,13,22,2,37
Macroramphosus scolopax,16016,13,22,2,37
Eurypegasus draconis,16015,13,22,2,37
Pegasus volitans,16514,13,22,2,37
Fistularia commersonii,16458,13,22,2,37
Aulorhynchus flavidus,16894,13,22,2,37
Solenostomus cyanopterus,16583,13,22,2,37
Aeoliscus strigatus,16392,13,22,2,37
Ctenopharyngodon idella,16609,13,22,2,37
Heteronotia binoei,25972,15,31,4,50
Pteragogus flagellifer,16793,13,22,2,37
Trichechus manatus,16882,13,22,2,37
Eulemur mongoz,16686,13,22,2,37
Dendrohyrax dorsalis,16590,13,22,2,37
Hylomys suillus,15353,13,21,2,36
Eremitalpa granti,16602,13,22,2,37
Cycas taitungensis,414903,39,26,3,68
Mus musculus musculus,16300,13,22,2,37
Megalobrama amblycephala,16623,13,22,2,37
Polytomella capuana,12998,7,1,12,20
Loxocorone allax,14862,13,22,2,37
Loxosomella aloxiata,15323,13,23,2,38
Brachionus plicatilis,11153,4,13,2,19
Brachionus plicatilis,12672,8,9,0,17
Spilogale putorius,16597,13,22,2,37
Suberites domuncula,26300,14,25,2,41
Phthonandria atrilineata,15499,13,22,2,37
Seriatopora hystrix,17059,13,3,2,18
Seriatopora caliendrum,17010,13,3,2,18
Canis lupus chanco,16774,13,22,2,37
Toxocara malaysiensis,14266,12,22,2,36
Orchesella villosa,14924,13,22,2,37
Trigoniophthalmus alternatus,16197,13,22,2,37
Sminthurus viridis,14817,13,22,2,37
Cryptopygus antarcticus,15297,13,23,2,38
Elysia chlorotica,14132,13,21,2,36
Pieris melete,15140,13,22,2,37
Arapaima gigas,16433,13,22,2,37
Dugong dugon,16850,13,22,2,37
Tachyglossus aculeatus,16360,13,22,2,37
Lepidosiren paradoxa,16403,13,22,2,37
Thyropygus sp. DVL-2001,15133,13,22,2,37
Narceus annularus,14868,13,22,2,37
Walchia hayashii,14857,13,22,2,37
Crioceris duodecimpunctata,15880,13,22,2,37
Saturnia boisduvalii,15360,13,22,2,37
Sthenoteuthis oualaniensis,20306,18,23,2,43
Hemiselmis andersenii,60553,44,28,2,74
Panthera uncia,16773,13,22,2,37
Mecistops cataphractus,16847,13,22,2,37
Capricornis swinhoei,16524,13,22,2,37
Tilletia walkeri,59352,14,24,0,38
Cavenderia fasciculata,54563,48,17,2,67
Toxocara canis,14322,12,22,2,36
Ophiura albida,16580,13,22,2,37
Antedon mediterranea,16156,13,22,2,37
Beauveria bassiana,29961,15,25,2,42
Toxocara cati,14029,12,22,2,36
Buthus occitanus,15060,13,21,2,36
Lophura ignita,16688,13,22,2,37
Phasianus versicolor,16690,13,22,2,37
Syrmaticus ellioti,16688,13,22,2,37
Syrmaticus humiae,16686,13,22,2,37
Syrmaticus reevesii,16678,13,22,2,37
Aphrocallistes vastus,17427,13,18,2,33
Phalangium opilio,14968,13,21,2,36
Hypochilus thorelli,13991,13,22,2,37
Syrmaticus soemmerringii ijimae,16690,13,22,2,37
Keratoisidinae sp. BAL208-1,18923,14,1,2,17
Eremobates cf. palpisetulosus SEM-2008,15083,13,22,2,37
Uroctonus mordax,14840,13,22,2,37
Cobitis choii,16566,13,22,2,37
Oncorhynchus gorbuscha,16785,13,22,2,37
Varanus salvator,17489,13,22,2,37
Cuora mouhotii,16837,13,22,2,37
Oplegnathus fasciatus,16511,13,22,2,37
Platichthys stellatus,17103,13,22,2,37
Capros aper,15976,13,22,2,37
Sphoeroides pachygaster,16444,13,22,2,37
Lutjanus russellii,16505,13,22,2,37
Platalea minor,16918,13,22,2,37
Cyclemys atripons,16500,13,22,2,37
Arothron firmamentum,16474,13,22,2,37
Canthigaster coronata,16446,13,22,2,37
Canthigaster rivulata,16446,13,22,2,37
Gyrodactylus derjavinoides,14741,12,22,2,36
Monotaxis grandoculis,16174,13,22,2,37
Rhagophthalmus lufengensis,15982,13,22,2,37
Metaperipatus inae,15347,13,22,2,37
Amerotyphlops reticulatus,16681,13,22,2,37
Ancylostoma duodenale,13721,12,22,2,36
Terebellides stroemii,15755,13,23,2,38
Gonorynchus abbreviatus,16535,13,22,2,37
Sagamichthys abei,17143,13,22,2,37
Alepocephalus bicolor,16829,13,22,2,37
Bathyprion danae,16757,13,22,2,37
Bathytroctes microlepis,16610,13,22,2,37
Leptochilichthys agassizii,16629,13,22,2,37
Maulisia mauli,17053,13,22,2,37
Narcetes erimelas,16744,13,22,2,37
Normichthys operosus,17488,13,22,2,37
Ochotona curzoniae,17131,13,22,2,37
Ursus americanus,16841,13,22,2,37
Oryza sativa Japonica Group,490520,53,22,3,78
Spirometra erinaceieuropaei,13643,12,22,2,36
Unionicola foili,14738,13,22,2,37
Bombina maxima,18388,13,22,2,37
Hemibarbus labeo,16612,13,22,2,37
Hemibarbus mylodon,16605,13,22,2,37
Hemibarbus longirostris,16608,13,22,2,37
Coreoleuciscus splendidus,16566,13,22,2,37
Acanella arbuscula,18616,14,1,2,17
Sinonovacula constricta,17225,12,19,2,33
Tomistoma schlegelii,16345,13,22,2,37
Megaulacobothrus chinensis,15599,13,22,2,37
Ursus spelaeus,16780,13,22,2,37
Epinephelus coioides,16418,13,22,2,37
Epinephelus akaara,16795,13,22,2,37
Oedaleus asiaticus,16259,13,22,2,37
Gastrimargus marmoratus,15924,13,22,2,37
Arctodus simus,16754,13,22,2,37
Ursus thibetanus ussuricus,16824,13,22,2,37
Ursus thibetanus thibetanus,17034,13,22,2,37
Locusta migratoria migratoria,16053,13,22,2,37
Echinococcus ortleppi,13717,12,22,2,36
Echinococcus canadensis,13721,12,22,2,36
Theileria parva,5895,3,0,5,8
Ailurus fulgens,16493,13,22,2,37
Meles meles,16442,13,22,2,37
Haemonchus contortus,14055,12,22,2,36
Candida neerlandica,32141,18,24,2,44
Mylopharyngodon piceus,16609,13,22,2,37
Madracis myriaster,16951,13,2,2,17
Tylochromis polylepis,16976,13,22,2,37
Aplocheilus panchax,16519,13,22,2,37
Paratilapia polleni,16543,13,22,2,37
Oryzias sarasinorum,16462,13,22,2,37
Ablennes hians,16825,13,22,2,37
Ptychochromoides katria,16556,13,22,2,37
Menidia menidia,16456,13,22,2,37
Hyporhamphus sajori,16721,13,22,2,37
Odontesthes sp. Odsp-001,16527,13,22,2,37
Iso hawaiiensis,16567,13,22,2,37
Chelydra serpentina,16631,13,22,2,37
Anser anser,16738,13,22,2,37
Bilobella aurantiaca,16312,13,24,2,39
Beauveria brongniartii,33926,20,25,2,47
Halichoeres trimaculatus,16621,13,22,2,37
Halichoeres tenuispinis,17222,13,23,2,38
Procypris rabaudi,16595,13,22,2,37
Gampsocleis gratiosa,15929,13,22,2,37
Atelura formicaria,15205,13,22,2,37
Rapana venosa,15272,13,22,2,37
Distoechodon tumirostris,16620,13,22,2,37
Misgurnus anguillicaudatus,16565,13,22,2,37
Rhodeus ocellatus,16680,13,22,2,37
Rachycentron canadum,16758,13,22,2,37
Blastocystis sp. DMP/02-328,27719,27,16,2,45
Blastocystis sp. ATCC 50177/Nand II,28382,27,16,2,45
Hydra vulgaris,8194,6,2,1,9
Acropora tenuis,18338,13,2,2,17
Lutjanus bengalensis,16511,13,22,2,37
Corydalus cornutus,15687,13,22,2,37
Ascaloptynx appendiculata,15877,13,22,2,37
Damon diadema,14786,13,22,2,37
Falco tinnunculus,17663,13,22,2,37
Acrida willemsei,15601,13,22,2,37
Myrmecophilus manni,15323,13,22,2,37
Calliptamus italicus,15675,13,22,2,37
Rhinolophus formosae,16915,13,22,2,37
Gryllotalpa pluvialis,15525,13,22,2,37
Troglophilus neglectus,15810,13,23,2,38
Trachypachus holmbergi,15722,13,22,2,37
Priasilpha obscura,16603,13,22,2,37
Aluterus scriptus,16451,13,22,2,37
Lactoria diaphana,16486,13,22,2,37
Thamnaconus modestus,16440,13,22,2,37
Xenobalistes tumidipectoris,16518,13,22,2,37
Cantherhines pardalis,16426,13,22,2,37
Anoplocapros lenticularis,16492,13,22,2,37
Chilomycterus reticulatus,16519,13,22,2,37
Contacyphon sp. BT0012,15919,13,22,2,37
Sphaerius sp. BT0074,15121,13,22,2,37
Chaetosoma scaritides,15511,13,22,2,37
Tetraphalerus bruchi,15689,13,22,2,37
Scarus rubroviolaceus,16681,13,22,2,37
Blastocladiella emersonii,36503,17,26,2,45
Lutra lutra,16536,13,22,2,37
Parafronurus youi,15481,13,23,2,38
Fundulus olivaceus,16509,13,22,2,37
Jordanella floridae,16177,13,22,2,37
Elassoma zonatum,16071,13,22,2,37
Naja atra,17216,13,22,2,37
Gloydius brevicaudus,17227,13,22,2,37
Daboia russelii,17246,13,22,2,37
Bungarus fasciatus,17234,13,22,2,37
Macaca thibetana,16540,13,22,2,37
Rusa unicolor swinhoei,16505,13,22,2,37
Protohermes concolorus,15851,13,22,2,37
Chondrus crispus,25836,29,24,4,57
Naumovozyma castellii,25753,9,23,2,34
Aulichthys japonicus,16594,13,22,2,37
Gasterosteus wheatlandi,16538,13,22,2,37
Pungitius pungitius,16388,13,22,2,37
Symphylella sp. YG-2006,14667,13,22,2,37
Anguilla luzonensis,16635,13,22,2,37
Achalinus meiguensis,17239,13,22,2,37
Culaea inconstans,16465,13,22,2,37
Lutjanus kasmira,16514,13,22,2,37
Martes zibellina,16523,13,22,2,37
Apeltes quadracus,16472,13,22,2,37
Architeuthis dux,20331,18,23,2,43
Spinachia spinachia,16359,13,22,2,37
Pyrocoelia rufa,17739,13,22,2,37
Taenia solium,13709,12,22,2,36
Lemur catta,17036,13,22,2,37
Macroscelides proboscideus,16641,13,22,2,37
Arctocephalus forsteri,15413,13,22,2,37
Tamandua tetradactyla,16395,13,22,2,37
Phataginus tetradactyla,16571,13,22,2,37
Laminaria digitata,38007,39,24,3,66
Ranodon sibiricus,16418,13,22,2,37
Lepus europaeus,17734,13,22,2,37
Drosophila littoralis,16017,13,22,2,37
Scarus ghobban,16676,13,22,2,37
Phoenicolacerta kulzeri,17199,13,22,2,37
Podarcis siculus,17297,13,22,2,37
Arenaria interpres,16725,13,22,2,37
Takifugu poecilonotus,16448,13,22,2,37
Takifugu exascurus,16443,13,22,2,37
Chelonodontops patoca,16720,13,22,2,37
Takifugu chrysops,16448,13,22,2,37
Takifugu alboplumbeus,16442,13,22,2,37
Takifugu obscurus,16445,13,22,2,37
Takifugu pardalis,16463,13,22,2,37
Takifugu porphyreus,16447,13,22,2,37
Takifugu stictonotus,16451,13,22,2,37
Takifugu snyderi,16450,13,22,2,37
Takifugu vermicularis,16443,13,22,2,37
Takifugu xanthopterus,16442,13,22,2,37
Takifugu chinensis,16447,13,22,2,37
Takifugu oblongus,16444,13,22,2,37
Takifugu ocellatus,16449,13,22,2,37
Torquigener brevipinnis,16441,13,22,2,37
Lagocephalus wheeleri,16453,13,22,2,37
Rattus tanezumi,16306,13,22,2,37
Pampus sp. LY-2009,17694,13,22,2,37
Agapornis roseicollis,16732,13,22,2,37
Urodynamis taitensis,17559,13,22,2,37
Geococcyx californianus,17091,13,22,2,37
Todiramphus sanctus vagans,17549,13,22,2,37
Trogon viridis,17751,13,22,2,37
Pedetontus silvestrii,15879,13,22,2,37
Trichiurus japonicus,16796,13,21,2,36
Nezara viridula,16889,13,22,2,37
Hyriopsis cumingii,15954,13,22,2,37
Eremias brenchleyi,19542,13,22,2,37
Muntiacus reevesi,16354,13,22,2,37
Deracantha onos,15650,13,22,2,37
Manouria impressa,16642,13,22,2,37
Bambusicola thoracicus,16726,13,22,2,37
Francolinus pintadeanus,16694,13,22,2,37
Sacalia quadriocellata,16816,13,22,2,37
Teleogryllus emma,15660,13,22,2,37
Atractomorpha sinensis,15558,13,22,2,37
Mitsukurina owstoni,17743,13,22,2,37
Sipunculus nudus,15502,13,22,2,37
Phlaeoba albonema,15657,13,22,2,37
Nelusetta ayraudi,16297,13,22,2,37
Bombus hypocrita sapporensis,15468,13,21,2,36
Monacanthus chinensis,16430,13,22,2,37
Scobinichthys granulatus,16440,13,22,2,37
Oxymonacanthus longirostris,16597,13,22,2,37
Scarus forsteni,16679,13,22,2,37
Paraluteres prionurus,16427,13,22,2,37
Paramonacanthus choirocephalus,16425,13,22,2,37
Pervagor janthinosoma,16526,13,22,2,37
Pseudomonacanthus peroni,16434,13,22,2,37
Balistoides conspicillum,16549,13,22,2,37
Canthidermis maculata,16524,13,22,2,37
Scarus schlegeli,16701,13,22,2,37
Melichthys vidua,16503,13,22,2,37
Odonus niger,16554,13,22,2,37
Pseudobalistes flavimarginatus,16515,13,22,2,37
Brachaluteres ulvarum,16421,13,22,2,37
Rhinecanthus aculeatus,16491,13,22,2,37
Abalistes stellaris,16502,13,22,2,37
Thylacinus cynocephalus,17411,13,22,2,37
Xanthichthys auromarginatus,16515,13,22,2,37
Balistapus undulatus,16492,13,22,2,37
Acanthaluteres brownii,16441,13,22,2,37
Balistes vetula,16518,13,22,2,37
Myrmecobius fasciatus,16813,13,22,2,37
Acreichthys tomentosus,16446,13,22,2,37
Amanses scopas,16440,13,22,2,37
Eubalichthys mosaicus,16442,13,22,2,37
Pseudalutarius nasicornis,16582,13,22,2,37
Meuschenia hippocrepis,16438,13,22,2,37
Sinogastromyzon puliensis,16551,13,22,2,37
Chaetodermis penicilligerus,16433,13,22,2,37
Eutaeniophorus festivus,16528,13,22,2,37
Parataeniophorus gulosus,16494,13,22,2,37
Ataxolepis apus,16528,13,22,2,37
Barbourisia rufa,16534,13,22,2,37
Procetichthys kreffti,16527,13,22,2,37
Cetomimus sp. AMS I34481001,16532,13,22,2,37
Gyrinomimus sp. UW 113191,16570,13,22,2,37
Gyrinomimus myersi,16568,13,22,2,37
Stenella coeruleoalba,16384,13,22,2,37
Pseudolabrus eoethinus,16508,13,22,2,37
Rhizophagus intraradices,70606,20,26,2,48
Sousa chinensis,16388,13,22,2,37
Tursiops aduncus,16385,13,22,2,37
Penaeus stylirostris,15988,13,22,2,37
Delphinus capensis,16385,13,22,2,37
Stenella attenuata,16386,13,22,2,37
Grampus griseus,16386,13,22,2,37
Sus scrofa domesticus,16770,13,22,2,37
Capricornis crispus,16453,13,22,2,37
Antilope cervicapra,16431,13,22,2,37
Giraffa giraffa angolensis,16433,13,22,2,37
Lama glama,16597,13,22,2,37
Pecari tajacu,16839,13,22,2,37
Carica papaya,476890,39,19,3,61
Vitis vinifera,773279,74,31,3,108
Aspidytes niobe,14257,13,19,2,34
Gallirallus okinawae,18404,13,22,2,37
Martes flavigula,16549,13,22,2,37
Rallina eurizonoides sepiaria,16942,13,22,2,37
Coturnicops exquisitus,17136,13,22,2,37
Hydroscapha granulum,15975,13,21,2,36
Saccharomyces pastorianus Weihenstephan 34/70,70578,9,24,2,35
Trimeresurus stejnegeri stejnegeri,17239,13,22,2,37
Chaetosphaeridium globosum,56574,46,28,3,77
Bunostomum phlebotomum,13790,12,22,2,36
Ancylostoma caninum,13717,12,22,2,36
Tarentola mauritanica,16593,13,22,2,37
Mus musculus castaneus,16299,13,22,2,37
Rattus exulans,16307,13,22,2,37
Eretmochelys imbricata,16478,13,22,2,37
Lissemys punctata,16490,13,22,2,37
Fundulus grandis,16524,13,22,2,37
Fundulus diaphanus,16531,13,22,2,37
Siphonaria pectinata,14065,13,22,2,37
Chamaeleo calyptratus,17433,13,22,2,37
Dysdercus cingulatus,16249,13,22,2,37
Haemoproteus sp. jb1.JA27,5970,0,0,0,0
Haemoproteus sp. jb2.SEW5141,5970,0,0,0,0
Plasmodium relictum,5996,0,0,0,0
Ascobulla fragilis,14745,13,23,2,38
Batrachuperus yenyuanensis,16394,13,22,2,37
Blanus cinereus,16969,13,22,2,37
Chamaeleo africanus,17415,13,22,2,37
Geocoris pallidipennis,14592,13,22,2,37
Chamaeleo chamaeleon,17470,13,22,2,37
Orius niger,14494,13,22,2,37
Physopelta gutta,14935,13,22,2,37
Myosotella myosotis,14246,13,22,2,37
Chamaeleo dilepis,17875,13,22,2,37
Pyramidella dolabrata,13856,13,22,2,37
Chamaeleo monachus,18900,13,22,2,37
Aeschyntelus notatus,14532,13,22,2,37
Rattus praetor,16293,13,22,2,37
Chamaeleo zeylanicus,18923,13,22,2,37
Chamaeleo arabicus,17400,13,22,2,37
Coptosoma bifaria,16179,13,22,2,37
Chamaeleo calcaricarens,17451,13,22,2,37
Hydaropsis longirostris,16521,13,22,2,37
Neuroctenus parus,15354,13,22,2,37
Phaenacantha marcida,14540,13,22,2,37
Riptortus pedestris,17191,13,22,2,37
Yemmalysus parallelus,15747,13,22,2,37
Kinyongia fischeri,18997,13,22,2,37
Pyrenophora tritici-repentis Pt-1C-BFP,157001,0,0,0,0
Plasmodium fragile,5977,3,0,0,3
Parahaemoproteus vireonis,5893,3,0,0,3
Leucocytozoon majoris,6684,3,0,0,3
Leucocytozoon fringillinarum,5992,3,0,0,3
Haemoproteus columbae,5988,3,0,0,3
Scylla serrata,15775,13,22,2,37
Scylla olivacea,15723,13,22,2,37
Panonychus ulmi,13115,13,22,2,37
Scylla paramamosain,15825,13,22,2,37
Tachypleus tridentatus,15008,13,22,2,37
Acipenser gueldenstaedtii,16594,13,22,2,37
Palaemon carinicauda,15730,13,22,2,37
Scylla tranquebarica,15833,13,22,2,37
Tropidophis haetianus,17138,13,22,2,37
Apostichopus japonicus,16099,13,22,2,37
Geisha distinctissima,15971,13,22,2,37
Phascolosoma esculenta,15494,13,22,2,37
Nakaseomyces delphensis,37016,8,23,2,33
[Candida] castellii,50294,8,23,2,33
Nakaseomyces bacillisporus,107123,8,23,2,33
Micromonas commoda,47425,39,34,6,79
Davidius lunatus,15913,13,22,2,37
Ephemera orientalis,16463,13,22,2,37
Acipenser sinensis,16682,13,22,2,37
Fejervarya cancrivora,17843,13,23,2,38
Crassostrea angulata,18225,12,25,4,41
Crassostrea sikamea,18243,12,25,4,41
Crassostrea ariakensis,18414,12,25,4,41
Nothoceros aenigmaticus,184908,48,18,3,69
Istiompax indica,16526,13,22,2,37
Istiophorus platypterus,16524,13,22,2,37
Xiphias gladius,16520,13,22,2,37
Kajikia audax,16526,13,22,2,37
Tetrapturus angustirostris,16509,13,22,2,37
Makaira mazara,16534,13,22,2,37
Coelodonta antiquitatis,16436,13,22,2,37
Diceros bicornis,16411,13,22,2,37
Rhinoceros sondaicus,16417,13,22,2,37
Dicerorhinus sumatrensis,16466,13,22,2,37
Panulirus japonicus,15717,13,22,2,37
Monosiga brevicollis ATCC 50154,76568,32,25,2,59
Tyrannodoris europaea,14472,13,22,2,37
Orussus occidentalis,15947,13,22,2,37
Schizosaccharomyces japonicus,80059,10,25,2,37
Watersipora subtorquata,14144,13,22,2,37
Clonorchis sinensis,13875,12,22,2,36
Opisthorchis felineus,14277,12,22,2,36
Moschus berezovskii,16354,13,22,2,37
Tigriopus californicus,14578,13,22,2,37
Brevimyrus niger,16753,13,22,2,37
Bos javanicus,16339,13,22,2,37
Diadegma semiclausum,18728,13,22,2,37
Anyperodon leucogrammicus,16616,13,22,2,37
Chitala lopis,16177,13,22,2,37
Chitala ornata,16164,13,22,2,37
Papyrocranus congoensis,16823,13,22,2,37
Cristaria plicata,15712,13,21,2,36
Notopterus notopterus,16030,13,22,2,37
Xenomystus nigri,16635,13,22,2,37
Eriogyna pyretorum,15327,13,22,2,37
Lutjanus malabaricus,16526,13,22,2,37
Lutjanus sebae,16512,13,22,2,37
Antheraea yamamai,15338,13,22,2,37
Penaeus californiensis,15975,13,22,2,37
Galago senegalensis,16795,13,22,2,37
Otolemur crassicaudatus,16827,13,22,2,37
Perodicticus potto,16638,13,22,2,37
Chrysochroa fulgidissima,15592,13,22,2,37
Eulemur fulvus fulvus,17126,13,22,2,37
Urechis unicinctus,15761,13,22,2,37
Eulemur fulvus mayottensis,17118,13,22,2,37
Oreocryptophis porphyraceus,17167,13,22,2,37
Eulemur macaco macaco,17149,13,22,2,37
Varecia variegata variegata,16965,13,22,2,37
Saimiri sciureus,16474,13,22,2,37
Platalea leucorodia,16715,13,22,2,37
Loris tardigradus,16776,13,22,2,37
Meretrix petechialis,19567,12,22,2,36
Paragonimus westermani,14965,12,23,1,36
Thermophis zhaoermii,17322,13,22,2,37
Laccotrephes robustus,15321,13,22,2,37
Enithares tibialis,15262,13,22,2,37
Cephalothrix simula,16296,13,22,2,37
Valentia hoffmanni,15625,13,22,2,37
Trichophyton mentagrophytes,24297,15,25,2,42
Oplurus grandidieri,17122,13,22,2,37
Arthroderma uncinatum,28530,15,25,2,42
Basiliscus vittatus,16948,13,22,2,37
Nannizzia nana,24105,15,25,2,42
Gambelia wislizenii,17563,13,22,2,37
Leiocephalus personatus,16681,13,22,2,37
Lycorma delicatula,15410,13,22,2,37
Chalarodon madagascariensis,16851,13,22,2,37
Polychrus marmoratus,17743,13,22,2,37
Doryteuthis opalescens,17387,13,22,2,37
Dendrocygna javanica,16753,13,22,2,37
Ilyocoris cimicoides,15209,13,22,2,37
Trichophyton rubrum,26985,17,25,2,44
Microsporum canis,23943,15,25,2,42
Cryptococcus neoformans var. grubii,24874,16,20,2,38
Clavelina lepadiformis,14484,12,24,2,38
Stictopleurus subviridis,15319,13,22,2,37
Lineus viridis,15388,13,22,2,37
Lymantria dispar,15569,13,22,2,37
Taenia multiceps,13693,12,22,2,36
Lophura nycthemera,16680,13,22,2,37
Taenia hydatigena,13492,12,22,2,36
Pavo muticus,16698,13,22,2,37
Oncomelania hupensis hupensis,15186,13,22,2,37
Polyplectron bicalcaratum,16702,13,22,2,37
Blattella germanica,15025,13,22,2,37
Branchiostegus japonicus,16541,13,22,2,37
Branchiostegus albus,16532,13,22,2,37
Branchiostegus argentatus,16550,13,22,2,37
Polyodon spathula,16512,13,22,2,37
Lophius americanus,16479,13,22,2,37
Gambusia affinis,16614,13,22,2,37
Ixodes persulcatus,14539,13,22,2,37
Petroscirtes breviceps,16680,13,22,2,37
Lota lota,16527,13,22,2,37
Rhyacichthys aspro,16518,13,22,2,37
Eleotris acanthopoma,16522,13,22,2,37
Anoplogaster cornuta,16511,13,22,2,37
Cetostoma regani,16508,13,22,2,37
Aphredoderus sayanus,16601,13,22,2,37
Beryx decadactylus,16535,13,22,2,37
Melanotaenia lacustris,16487,13,22,2,37
Hypoatherina tsurugae,16566,13,22,2,37
Cottus reinii,16561,13,22,2,37
Gymnothorax kidako,16579,13,22,2,37
Hypoptychus dybowskii,16479,13,22,2,37
Polypterus senegalus senegalus,16627,13,22,2,37
Scaphirhynchus cf. albus,16493,13,22,2,37
Carapus bermudensis,16613,13,22,2,37
Bassozetus zenkevitchi,16579,13,22,2,37
Cataetyx rubrirostris,16495,13,22,2,37
Diplacanthopoma brachysoma,16495,13,22,2,37
Lamprogrammus niger,16564,13,22,2,37
Melanocetus murrayi,16758,13,22,2,37
Eutaeniophorus sp. 033-Miya,16508,13,22,2,37
Monocentris japonicus,16567,13,22,2,37
Ostichthys japonicus,16541,13,22,2,37
Sargocentron rubrum,16526,13,22,2,37
Parazen pacificus,16848,13,22,2,37
Zenion japonicum,16843,13,22,2,37
Allocyttus niger,16750,13,22,2,37
Neocyttus rhomboidalis,16745,13,22,2,37
Indostomus paradoxus,16152,13,22,2,37
Dactyloptena tiltoni,16751,13,22,2,37
Scalicus amiscus,16526,13,22,2,37
Carangoides armatus,16556,13,22,2,37
Caranx melampygus,16593,13,22,2,37
Emmelichthys struhsakeri,16502,13,22,2,37
Pterocaesio tile,16496,13,22,2,37
Icelus toyamensis,16697,13,22,2,37
Pholis crassispina,16522,13,22,2,37
Sufflamen fraenatum,16584,13,22,2,37
Thymallus thymallus,16657,13,22,2,37
Dunaliella salina,28331,9,3,9,21
Argopecten irradians irradians,16211,12,21,2,35
Metacrangonyx longipes,14113,13,21,2,36
Rhopalomyia pomum,14503,13,22,2,37
Erimyzon oblongus,16627,13,22,2,37
Angiostrongylus cantonensis,13497,12,22,2,36
Mayetiola destructor,14759,13,22,2,37
Angiostrongylus costaricensis,13585,12,22,2,36
Tscherskia triton,16488,13,22,2,37
Budorcas taxicolor,16667,13,22,2,37
Psacothea hilaris,15856,13,22,2,37
Ictiobus bubalus,16612,13,22,2,37
Xenocypris davidi,16630,13,22,2,37
Oncomelania hupensis,15182,13,22,2,37
Moxostoma congestum,16626,13,22,2,37
Takifugu fasciatus,16444,13,22,2,37
Platax orbicularis,16561,13,22,2,37
Girella punctata,16518,13,22,2,37
Kyphosus cinerascens,16534,13,22,2,37
Labracoglossa argenteiventris,16492,13,22,2,37
Rhynchopelates oxyrhynchus,16631,13,22,2,37
Kuhlia mugil,16502,13,22,2,37
Oplegnathus punctatus,16509,13,22,2,37
Threskiornis aethiopicus,16960,13,22,2,37
Brettanomyces bruxellensis,76453,18,25,2,45
Siganus unimaculatus,16505,13,22,2,37
Hyperoglyphe japonica,16579,13,22,2,37
Cubiceps pauciradiatus,16522,13,22,2,37
Toxotes chatareus,16595,13,22,2,37
Neopanorpa pulchra,15531,13,22,2,37
Ramulus hainanense,15590,13,25,2,40
Sinocyclocheilus altishoulderus,16589,13,22,2,37
Oncomelania hupensis robertsoni,15191,13,22,2,37
Meretrix meretrix,19826,12,23,2,37
Evania appendigaster,17817,13,22,2,37
Schistocerca gregaria gregaria,15625,13,22,2,37
Fusiturris similis,15595,13,22,2,37
Conus borgesi,15536,13,22,2,37
Cymbium olla,15375,13,22,2,37
Charybdis japonica,15738,13,22,2,37
Macrogyrus oblongus,16643,13,22,2,37
Bolinus brandaris,15380,13,22,2,37
Mongoloraphidia harmandi,16006,13,22,2,37
Mordella atrata,15540,13,22,2,37
Sialis hamata,15608,13,22,2,37
Ditaxis biseriata,16416,13,22,2,37
Rhopaea magnicornis,17522,13,22,2,37
Millerozyma farinosa,39107,25,25,2,52
Quasipaa spinosa,18012,13,23,2,38
Loripes lacteus,17321,13,22,2,37
Diatraea saccharalis,15490,13,22,2,37
Lucinella divaricata,18940,13,22,2,37
Lagocephalus lunaris,16433,13,22,2,37
Carassius auratus x Megalobrama amblycephala tetraploid hybrid,16580,13,22,2,37
Carassius auratus x Megalobrama amblycephala triploid hybrid,16580,13,22,2,37
Parastichopus nigripunctatus,16112,13,22,2,37
Carassius auratus x Megalobrama amblycephala pentaploid hybrid,16580,13,22,2,37
Oryzias sinensis,16654,13,22,2,37
Pleurozia purpurea,168526,69,28,3,100
Cuon alpinus,16672,13,22,2,37
Causus defilippii,17342,13,22,2,37
Xenograpsus testudinatus,15798,13,22,2,37
Micrurus fulvius,17506,13,22,2,37
Rastrelliger brachysoma,16539,13,22,2,37
Candida albicans SC5314,40420,13,30,2,45
Plasmodium vivax Sal-1,5990,3,0,0,3
Babesia bovis T2Bo,6005,3,0,5,8
Polytomella piriformis,13004,6,1,12,19
Polytomella piriformis,3079,1,0,0,1
Adelium sp. NCS-2009,16449,13,22,2,37
Herwigia kreffti,16637,13,22,2,37
Leptoderma lubricum,16598,13,22,2,37
Vicugna vicugna,16084,13,22,2,37
Leptoderma retropinna,16601,13,22,2,37
Narcetes stomias,16621,13,22,2,37
Herdmania momus,15816,13,24,2,39
Talismania bifurcata,16609,13,22,2,37
Proedromys liangshanensis,16296,13,22,2,37
Alepocephalus agassizii,16657,13,22,2,37
Styela plicata,14414,13,24,2,39
Alepocephalus australis,16640,13,22,2,37
Alepocephalus bairdii,16637,13,22,2,37
Rotaria rotatoria,15319,12,21,2,35
Whitmania pigra,14426,13,22,2,37
Alepocephalus productus,16636,13,22,2,37
Eothenomys chinensis,16362,13,22,2,37
Alepocephalus umbriceps,16640,13,22,2,37
Bathytroctes breviceps,16652,13,22,2,37
Bathytroctes macrolepis,16614,13,22,2,37
Chauliognathus opacus,14893,13,22,2,37
Bajacalifornia megalops,16798,13,22,2,37
Lucanus mazama,15261,13,22,2,37
Bathytroctes michaelsarsi,16616,13,22,2,37
Acmaeodera sp. NCS-2009,16217,13,22,2,37
Conocara macropterum,16606,13,22,2,37
Apatides fortis,16171,13,22,2,37
Conocara murrayi,16614,13,22,2,37
Aplidium conicum,15183,13,24,2,39
Gadus chalcogrammus,16571,13,22,2,37
Triops cancriformis,15101,13,22,2,37
Akanthomyces muscarius,24499,15,25,2,42
Euthynnus alletteratus,16520,13,22,2,37
Eudyptula minor,17611,13,22,2,37
Anser albifrons,16737,13,22,2,37
Haematopus ater,16791,13,22,2,37
Telchinia issoria,15245,13,23,2,38
Tragopan caboti,16727,13,22,2,37
Facciolella oxyrhyncha,17789,13,22,2,37
Moringua edwardsi,16841,13,22,2,37
Hoplunnis punctata,17828,13,22,2,37
Nettastoma parviceps,17714,13,22,2,37
Serrivomer beanii,16731,13,22,2,37
Paraconger notialis,17729,13,22,2,37
Myroconger compressus,16642,13,22,2,37
Robinsia catherinae,16627,13,22,2,37
Ilyophis brunneus,16682,13,22,2,37
Myrichthys maculosus,17859,12,22,2,36
Crassostrea hongkongensis,18622,12,25,4,41
Quadrula quadrula,16033,13,22,2,37
Venustaconcha ellipsiformis,17174,13,22,2,37
Pyganodon grandis,15848,13,22,2,37
Ircinia strobilina,16414,14,2,2,18
Ornithodoros moubata,14398,13,22,2,37
Muntiacus muntjak,16354,13,22,2,37
Nyctereutes procyonoides,16713,13,22,2,37
Ognevia longipennis,15621,13,22,2,37
Acheilognathus signifer,16566,13,22,2,37
Laodelphax striatellus,16513,13,22,2,37
Haliotis tuberculata tuberculata,16521,13,22,2,37
Gandalfus yunohana,15567,13,22,2,37
Scomber japonicus,16568,13,22,2,37
Scomber colias,16570,13,22,2,37
Scomber australasicus,16570,13,22,2,37
Ulnaria acus,46657,35,23,2,60
Naemorhedus caudatus,16519,13,22,2,37
Microcosmus sulcatus,15028,13,25,2,40
Moschus moschiferus,16351,13,22,2,37
Larimichthys polyactis,16470,13,22,2,37
Ciona savignyi,14737,12,24,2,38
Pseudogobio esocinus,16609,13,22,2,37
Lubomirskia baikalensis,28958,14,25,2,41
Gila conspersa,16595,13,22,2,37
Hynobius guabangshanensis,16408,13,22,2,37
Raiamas senegalensis,16854,13,22,2,37
Phaeoceros laevis,209482,38,20,3,61
Coturnix chinensis,16687,13,22,2,37
Muntiacus crinifrons,16357,13,22,2,37
Galaxias maculatus,16508,13,22,2,37
Dallia pectoralis,17157,13,22,2,37
Glossanodon semifasciatus,16627,13,22,2,37
Nansenia ardesiaca,16620,13,22,2,37
Platytroctes apus,16632,13,22,2,37
Arcyptera coreana,15783,13,22,2,37
Apteryx owenii,17020,13,22,2,37
Trichostrongylus vitrinus,13800,12,22,2,36
Candida viswanathii,39242,17,25,2,44
Zonosagitta nagae,11459,11,1,2,14
Decipisagitta decipiens,11121,11,1,2,14
Sebastiscus marmoratus,17301,13,22,2,37
Metastrongylus pudendotectus,13793,12,22,2,36
Sagitta enflata,12631,11,1,2,14
Metastrongylus salmi,13778,12,22,2,36
Oesophagostomum dentatum,13869,12,22,2,36
Epinephelus bruneus,16686,13,22,2,37
Syngamus trachea,14647,12,22,2,36
Siphlonurus immanis,15529,13,22,2,37
Trichostrongylus axei,13653,12,22,2,36
Hynobius yangi,16424,13,22,2,37
Traulia szetschuanensis,15768,13,22,2,37
Teladorsagia circumcincta,14066,12,22,2,36
Clinocottus analis,18374,13,23,2,38
Hyporthodus septemfasciatus,16558,13,22,2,37
Candida maltosa,62949,15,26,2,43
Chabertia ovina,13682,12,22,2,36
Hypoplectrus gemma,16911,13,23,2,38
Tricula hortensis,15179,13,22,2,37
Cervus nippon hortulorum,16434,13,22,2,37
Prumna arctica,15628,13,22,2,37
Cervus elaphus xanthopygus,16416,13,22,2,37
Pycnonotus sinensis,16923,13,22,2,37
Candida sojae,39415,21,29,3,53
Cervus hanglu yarkandensis,16351,13,22,2,37
Palea steindachneri,17243,13,22,2,37
Cheilinus undulatus,16613,13,22,2,37
Taenia pisiformis,13387,12,22,2,36
Beryx mollis,16537,13,22,2,37
Gomphocerus licenti,15597,13,22,2,37
Mecistocirrus digitatus,15221,12,22,2,36
Salangichthys microdon,16598,13,22,2,37
Alepocephalus tenebrosus,16644,13,22,2,37
Retropinna retropinna,16563,13,22,2,37
Opisthoproctus soleatus,16645,13,22,2,37
Oryza rufipogon,559045,41,15,3,59
Rhynchactis macrothrix,17072,13,22,2,37
Haplophryne mollis,17209,13,22,2,37
Melanocetus johnsonii,16871,13,22,2,37
Himantolophus albinares,16440,13,22,2,37
Himantolophus groenlandicus,16438,13,22,2,37
Diceratias pileatus,16431,13,22,2,37
Oneirodes thompsoni,17391,13,22,2,37
Lophiodes caulinaris,16471,13,22,2,37
Sladenia gardineri,16435,13,22,2,37
Thaumatichthys pagidostomus,16828,13,22,2,37
Balanoglossus clavigerus,15710,13,22,2,37
Cryptopsaras couesii,18350,13,22,2,37
Echinocardium cordatum,15767,13,22,2,37
Ceratias uranoscopus,18365,13,22,2,37
Chaunax pictus,16487,13,22,2,37
Holothuria forskali,15841,13,22,2,37
Gigantactis vanhoeffeni,17205,13,22,2,37
Coelophrys brevicaudata,16862,13,22,2,37
Hypoderma lineatum,16354,13,22,2,37
Trametes cingulata,91500,20,25,2,47
Pycnococcus provasolii,24321,18,16,2,36
Pycnonotus taivanus,16923,13,22,2,37
Monoblepharella sp. JEL15,60432,26,9,3,38
Harpochytrium sp. JEL105,24169,14,8,3,25
Hypsiglena jani texana,17203,13,22,2,37
Eophreatoicus sp. 14 FK-2009,14994,13,22,2,37
Hypsiglena chlorophaea chlorophaea,17209,13,22,2,37
Lophophorus lhuysii,16712,13,22,2,37
Hypsiglena ochrorhyncha ochrorhyncha,17208,13,22,2,37
Pseudoleptodeira latifasciata,18329,13,22,2,37
Hypsiglena sp. DGM-2008,17205,13,22,2,37
Hypsiglena ochrorhyncha nuchalata,17207,13,22,2,37
Hypsiglena ochrorhyncha klauberi,17205,13,22,2,37
Sibon nebulatus,22887,13,22,2,37
Hypsiglena slevini,17197,13,22,2,37
Imantodes cenchoa,22144,13,22,2,37
Hypsiglena chlorophaea deserticola,17209,13,22,2,37
Leptodeira polysticta,23038,13,22,2,37
Hypsiglena torquata,17203,13,22,2,37
diploid Megalobrama amblycephala x Xenocypris davidi,16623,13,22,2,37
triploid Megalobrama amblycephala x Xenocypris davidi,16623,13,22,2,37
Bos primigenius,16338,13,22,2,37
Saccostrea mordax,16532,12,22,3,37
Vermamoeba vermiformis,51645,46,25,2,73
Homo sapiens subsp. 'Denisova',16570,13,22,2,37
Strongylus vulgaris,14301,12,22,2,36
Podospora anserina,100314,52,27,2,81
Cervus elaphus,16357,13,22,2,37
Dictyostelium citrinum,57820,42,19,2,63
Hylobates agilis,16500,13,22,2,37
Bison bonasus,16326,13,22,2,37
Hylobates pileatus,16502,13,22,2,37
Otis tarda,16849,13,22,2,37
Symphalangus syndactylus,16516,13,22,2,37
Nomascus siki,16476,13,22,2,37
Apalone ferox,16866,13,22,2,37
Hyphantria cunea,15481,13,22,2,37
Oreochromis sp. 'red tilapia',16627,13,22,2,37
Thunnus albacares,16527,13,22,2,37
Citrullus lanatus,379236,39,18,3,60
Cucurbita pepo,982833,38,13,3,54
Thunnus maccoyii,16527,13,22,2,37
Cuora galbinifrons,17244,13,22,2,37
Apteronotus albifrons,15897,13,22,2,37
Eigenmannia sp. CBM-ZF-10620,16571,13,22,2,37
Phenacogrammus interruptus,16652,13,22,2,37
Chalceus macrolepidotus,16850,13,22,2,37
Tachysurus tokiensis,16529,13,22,2,37
Sarcocheilichthys variegatus microoculus,16665,13,22,2,37
Cobitis striata,16572,13,22,2,37
Lefua echigonia,16559,13,22,2,37
Corydoras rabauti,16831,13,22,2,37
Gonorynchus greyi,16536,13,22,2,37
Uncinocarpus reesii 1704,21803,0,0,0,0
Brookesia decaryi,17324,13,22,2,37
Trioceros melleri,16832,13,22,2,37
Leiolepis guttata,16552,13,22,2,37
Acryllium vulturinum,16748,13,22,2,37
Oesophagostomum quadrispinulatum,13681,12,22,2,36
Silurus glanis,16526,13,22,2,37
Collichthys niveatus,16469,13,22,2,37
Thryssa baelama,16865,13,22,2,37
Amazonsprattus scintilla,16720,13,22,2,37
Brevoortia tyrannus,16692,13,22,2,37
Pellona flavipinnis,16742,13,22,2,37
Anchoviella sp. LBP 2297,16660,13,22,2,37
Lethenteron reissneri,16461,13,22,2,37
Coilia lindmani,16835,13,22,2,37
Cotesia vestalis,15543,13,22,2,37
Opisthopatus cinctipes,13673,13,13,2,28
Eupolyphaga sinensis,15553,13,22,2,37
Anopheles darlingi,15386,13,22,2,37
Coilia reynaldi,17064,13,22,2,37
Lycothrissa crocodilus,17069,13,22,2,37
Spathius agrili,15425,13,22,2,37
Lycengraulis grossidens,16671,13,22,2,37
Callorhinchus callorynchus,16758,13,22,2,37
Setaria digitata,13839,12,22,2,36
Liriomyza trifolii,16141,13,24,2,39
Callorhinchus capensis,16760,13,22,2,37
Chimaera fulva,21336,13,22,2,37
Hydrolagus lemures,21233,13,22,2,37
Benedenia seriolae,13498,12,22,2,36
Harriotta raleighana,18024,13,22,2,37
Rhinochimaera pacifica,24889,13,22,2,37
Spilonota lechriaspis,15368,13,22,2,37
Paramecium caudatum,43660,42,3,4,49
Acipenser transmontanus,16692,13,22,2,37
Amia calva,16210,13,22,2,37
Brettanomyces custersianus,30058,19,25,2,46
[Candida] subhashii,29795,17,24,2,43
Proteromonas lacertae,48663,39,45,4,88
Panulirus stimpsoni,15677,13,22,2,37
Oratosquilla oratoria,15783,13,22,2,37
Anilius scytale,17713,13,22,2,37
Phakopsora pachyrhizi,31825,15,24,2,41
Panonychus citri,13075,13,22,2,37
Gomphocerippus rufus,15598,13,22,2,37
Collichthys lucidus,16442,13,22,2,37
Miichthys miiuy,16493,13,22,2,37
Phakopsora meibomiae,32520,15,24,2,41
Morone saxatilis,17580,13,23,2,38
Teinopalpus aureus,15242,13,22,2,37
Tetranychus cinnabarinus,13092,13,22,2,37
Cuora pani,16922,13,22,2,37
Bactrocera minax,16043,13,22,2,37
Amalda northlandica,15354,13,22,2,37
Hapalogenys nigripinnis,16478,13,22,2,37
Harpochytrium sp. JEL94,19473,14,8,3,25
Rhea pennata,16749,13,22,2,37
Euchorthippus fusigeniculatus,15772,13,22,2,37
Mekongiana xiangchengensis,15567,13,22,2,37
Mekongiella xizangensis,15885,13,22,2,37
Lepilemur hubbardorum,16854,13,22,2,37
Stichopus horrens,16257,13,22,2,37
Lynx rufus,17056,13,22,2,37
Rhizophagus irregularis,70800,30,25,2,57
Xyleus modestus,15723,13,22,2,37
Physemacris variolosa,17004,13,22,2,37
Caprella mutica,15427,13,22,2,37
Euphaea formosa,15700,13,22,2,37
Tanystylum orbiculare,15251,13,22,2,37
Silene latifolia,253413,30,10,3,43
Gnathonemus petersii,16687,13,22,2,37
Cooperia oncophora,13636,12,22,2,36
Ambystoma barbouri,16365,13,22,2,37
Ambystoma texanum,16367,13,22,2,37
Ambystoma unisexual lineage LJJJ,16367,13,22,2,37
Culex quinquefasciatus,15587,13,22,2,37
Chrysolophus pictus,16678,13,22,2,37
Kinosternon leucostomum,16559,13,22,2,37
Symsagittifera roscoffensis,14803,12,21,2,35
Paphia euglypta,18643,12,23,2,37
Dendropoma gregarium,15641,13,23,2,38
Eualetes tulipa,15078,13,22,2,37
Leiocassis longirostris,16534,13,22,2,37
Hipparchia autonoe,15489,13,22,2,37
Arcuatula senhousia,20612,13,22,2,37
Benedenia hoshinai,13554,12,22,2,36
Thrinchus schrenkii,15672,13,22,2,37
Bactrocera tryoni,15925,13,22,2,37
Candida alai,30368,14,25,2,41
Groenewaldozyma salmanticensis,27812,16,25,2,43
Solenopsis geminata,15552,13,22,2,37
Crocodylus mindorensis,16939,13,22,2,37
Micadina phluctainoides,16507,13,22,2,37
Solenopsis richteri,15560,13,22,2,37
Phobaeticus serratipes,16182,13,22,2,37
Heteropteryx dilatata,16618,13,22,2,37
Unionicola parkeri,14734,13,22,2,37
Occidozyga martensii,18321,13,23,2,38
Micropterus salmoides salmoides,16486,13,22,2,37
Caprella scaura,15079,13,22,2,37
Megacrania alpheus adan,17124,13,22,2,37
Micropterus floridanus,16479,13,22,2,37
Alosa sapidissima,16697,13,22,2,37
Leiopelma archeyi,16593,13,22,2,37
Sus scrofa taivanus,16480,13,22,2,37
Candida jiufengensis,29672,17,24,2,43
Leggadina lakedownensis,16262,13,22,2,37
Pseudomys chapmani,16249,13,22,2,37
Opilio parietinus,15400,13,22,2,37
Rucervus eldii,16357,13,22,2,37
Ramulus irregulariterdentatus,16633,13,22,2,37
Cervus canadensis songaricus,16419,13,22,2,37
Exorista sorbillans,14960,13,22,2,37
Phraortes sp. Iriomote Island,16867,13,22,2,37
Crocodylus palustris,17052,13,22,2,37
Phraortes illepidus,16456,13,22,2,37
Entoria okinawaensis,16910,13,22,2,37
Sphenodon punctatus,15181,12,21,2,35
Lepidopsocidae sp. RS-2001,16924,13,22,2,37
Cuora amboinensis,16708,13,22,2,37
Panthera tigris amoyensis,17001,13,22,2,37
Gracilariophila oryzoides,25161,23,19,2,44
Gracilariopsis andersonii,27036,27,18,2,47
Plocamiocolax pulvinata,25894,24,20,2,46
Ogataea angusta,41719,19,26,2,47
Grapholita molesta,15717,13,22,2,37
Meretrix lusoria,20268,13,22,2,37
Hemidactylus frenatus,16891,13,22,2,37
Oscarella viridis,20440,15,27,2,44
Rattus lutreolus,16295,13,22,2,37
Plakina jani,18907,14,5,2,21
Rattus tunneyi,16292,13,22,2,37
Rattus villosissimus,16303,13,22,2,37
Paranemertes cf. peregrina SCS-2010,14558,13,22,2,37
Silurus meridionalis,16527,13,22,2,37
Rattus fuscipes,16301,13,22,2,37
Plakortis simplex,18551,14,5,2,21
Cephalothrix sp. SCS-2010,15800,13,22,2,37
Procapra przewalskii,16548,13,22,2,37
Cynoglossus abbreviatus,16417,13,22,2,37
Alpheus distinguendus,15700,13,22,2,37
Plakina monolopha,19371,14,5,2,21
Plakina crypta,20069,14,5,2,21
Oscarella malakhovi,20332,14,26,2,42
Acrida cinerea,15599,13,22,2,37
Oscarella tuberculata,20262,15,27,2,44
Plakina sp. DVL-2010,18997,14,5,2,21
Oscarella lobularis,20260,15,27,2,44
Contracaecum rudolphii B Bullini et al._ 1986,14022,12,22,2,36
Corticium candelabrum,18402,14,5,2,21
Rattus sordidus,16309,13,22,2,37
Halisarca harmelini,20591,14,25,2,41
Rattus leucopus,16297,13,22,2,37
Panulirus ornatus,16105,13,22,2,37
Oscarella microlobata,20368,15,27,2,44
Macrobrachium nipponense,15806,13,22,2,37
Calliope calliope,16841,13,22,2,37
Pristomyrmex punctatus,16180,13,22,2,37
Jenkinsia sp. CL54,17507,13,22,2,37
Ixobrychus cinnamomeus,17180,13,22,2,37
Culex pipiens pipiens,14856,13,22,2,37
Penicillium digitatum,28978,15,27,2,44
Aceros waldeni,21657,14,25,2,41
Penelopides panini,22737,14,25,2,41
Aplysia dactylomela,14128,13,21,2,36
Myomyrus macrops,16697,13,22,2,37
Berthellina sp. TLT-2006,15688,13,22,2,37
Pollachius virens,16556,13,22,2,37
Pollachius pollachius,16539,13,22,2,37
Leptoderma macrophthalmum,16607,13,22,2,37
Mauremys megalocephala,16783,13,22,2,37
Micromesistius poutassou,16573,13,22,2,37
Micromelo undatus,14160,13,22,2,37
Sinohyriopsis schlegelii,15939,13,22,2,37
Notodoris gardineri,14424,13,22,2,37
Leiothrix argentauris,17833,13,22,2,37
Bittacus pilicornis,15842,13,22,2,37
Vigna radiata,401262,32,16,3,51
Glaucocystis nostochinearum,34087,34,25,3,62
Beta vulgaris subsp. maritima,364950,150,24,5,179
Ricinus communis,502773,37,20,3,60
Meleagris gallopavo,16719,13,22,2,37
Procavia capensis,16743,13,22,2,37
Elephantulus sp. VB001,16677,13,22,2,37
Kazachstania servazzii,30782,12,23,2,37
Andrias davidianus,16503,13,22,2,37
Brassica napus,11640,6,0,0,6
Parajulis poecilepterus,16441,13,22,2,37
Protopterus aethiopicus,15873,13,22,2,37
Channa argus,16559,13,22,2,37
Labeo bata,16605,13,22,2,37
Paralaubuca typus,16613,13,22,2,37
Acridotheres tristis,16822,13,22,2,37
Spinus spinus,16828,13,22,2,37
Pica pica,16939,13,22,2,37
Pennahia argentata,16485,13,22,2,37
Nibea albiflora,16499,13,22,2,37
Mogera wogura,16814,13,22,2,37
Urotrichus talpoides,16904,13,22,2,37
Hemiechinus auritus,17283,13,22,2,37
Anguilla japonica,16685,13,22,2,37
Anguilla rostrata,16678,13,22,2,37
Latimeria menadoensis,16446,13,22,2,37
Ostrea denselamellosa,16277,12,23,3,38
Cyanoptila cyanomelana,16802,13,22,2,37
Emberiza chrysophrys,16803,13,22,2,37
Crocodylus moreletii,16827,13,22,2,37
Gallinula chloropus,17027,13,22,2,37
Sturnus cineraceus,16821,13,22,2,37
Galaxias gollumoides,16506,13,22,2,37
Galaxias sp. 'southern',16511,13,22,2,37
Microtus fortis fortis,16310,13,22,2,37
Hypomesus nipponensis,16782,13,22,2,37
Microtus fortis calamorum,16310,13,22,2,37
Mallotus villosus,16648,13,22,2,37
Pristionchus pacificus,15954,12,22,2,36
Osmerus mordax,16620,13,22,2,37
Crassostrea nippona,20030,12,23,4,39
Odorrana ishikawae,21020,13,22,2,37
Cobitis takatsuensis,16647,13,22,2,37
Niwaella delicata,16571,13,22,2,37
Portunus trituberculatus,16026,13,22,2,37
Placozoan sp. 'Shirahama',36676,15,24,3,42
Unio pictorum,15760,13,22,2,37
Plasmodium berghei,5957,3,0,15,18
Coccomyxa subellipsoidea C-169,65497,31,26,3,60
Trichophyton rubrum CBS 118892,27683,0,0,0,0
Torquigener hypselogeneion,16404,13,22,2,37
Arothron hispidus,16483,13,22,2,37
Canthigaster valentini,16452,13,22,2,37
Polyspina piosae,16418,13,22,2,37
Lagocephalus sceleratus,16442,13,22,2,37
Sphoeroides parvus,16444,13,22,2,37
Megacopta cribraria,15647,13,22,2,37
Lagocephalus lagocephalus,16442,13,22,2,37
Sphoeroides annulatus,16449,13,22,2,37
Lagocephalus laevigatus,16449,13,22,2,37
Sphoeroides testudineus,16446,13,22,2,37
Tetractenos glaber,16524,13,22,2,37
Auriglobus modestus,16807,13,22,2,37
Omegophora armilla,16471,13,22,2,37
Carinotetraodon lorteti,16456,13,22,2,37
Carinotetraodon salivator,16437,13,22,2,37
Pelagocephalus marki,16472,13,22,2,37
Pao palembangensis,16467,13,22,2,37
Tylerius spinosissimus,16462,13,22,2,37
Tetraodon biocellatus,16450,13,22,2,37
Tetraodon miurus,16463,13,22,2,37
Tetraodon mbu,16508,13,22,2,37
Monotrete cochinchinensis,16451,13,22,2,37
Torquigener pleurogramma,16357,13,22,2,37
Colomesus asellus,16479,13,22,2,37
Chelonodontops pleurospilus,16468,13,22,2,37
Colomesus psittacus,16470,13,22,2,37
Arothron manilensis,16487,13,22,2,37
Canthigaster jactator,16513,13,22,2,37
Komagataella phaffii CBS 7435,35683,16,25,2,43
Moniliophthora roreri,93722,56,26,2,84
Leucocytozoon caulleryi,5959,3,0,15,18
Margaritifera falcata,16121,14,22,2,38
Utterbackia peninsularis,16803,14,22,2,38
Gomphocerus sibiricus tibetanus,15571,13,22,2,37
Utterbackia imbecillis,16103,14,22,2,38
Calinaga davidis,15267,13,22,2,37
Lasmigona compressa,15903,14,22,2,38
Sibirionetta formosa,16594,13,22,2,37
Toxolasma parvum,15949,14,22,2,38
Plecotus auritus,16900,13,22,2,37
Rhinopithecus avunculus,16548,13,22,2,37
Avocettina infans,16680,13,22,2,37
Stemonidium hypomelas,16566,13,22,2,37
Stylochyrus rarior,14900,13,22,2,37
Pseudotrapelus sinaitus,16560,13,22,2,37
Stichopus sp. SF-2010,16257,13,22,2,37
Danio dangila,16876,13,22,2,37
Rasbora daniconius,16886,13,22,2,37
Leptobarbus hoevenii,16552,13,22,2,37
Mammuthus columbi,16459,13,22,2,37
Brotogeris cyanoptera,17369,13,22,2,37
Rasboroides vaterifloris,16439,13,22,2,37
Psilorhynchus sucatio,16653,13,22,2,37
Barilius bendelisis,16529,13,22,2,37
Sewellia lineolata,16522,13,22,2,37
Cabdio morar,16418,13,22,2,37
Apatura metis,15236,13,22,2,37
Aphyocypris normalis,16619,13,22,2,37
Tanichthys albonubes,16547,13,22,2,37
Aphyocypris arcus,16617,13,22,2,37
Luciosoma bleekeri,16532,13,22,2,37
Horadandia atukorali,16735,13,22,2,37
Microdevario nana,16772,13,22,2,37
Raiamas guttatus,16506,13,22,2,37
Hemigrammocypris neglectus,16615,13,22,2,37
Salmostoma bacalia,16444,13,22,2,37
Macrochirichthys macrochirus,16857,13,22,2,37
Sarotherodon melanotheron,16627,13,22,2,37
Chilo suppressalis,15395,13,22,2,37
Acridotheres cristatellus,16820,13,22,2,37
Pseudorasbora parva,16600,13,22,2,37
Hymenochirus boettgeri,18007,13,22,2,37
Pipa carvalhoi,19534,13,22,2,37
Pseudhymenochirus merlini,18029,13,22,2,37
Rhinophrynus dorsalis,17299,13,22,2,37
Locusta migratoria tibetensis,15568,13,22,2,37
Pseudobagrus brevicorpus,16526,13,22,2,37
Fejervarya limnocharis,17717,13,23,2,38
Phytophthora mirabilis,37779,40,25,2,67
Libelloides macaronius,15890,13,22,2,37
Phytophthora phaseoli,37914,40,25,2,67
Phytophthora andina,37874,40,25,2,67
Anguilla bicolor pacifica,16693,13,22,2,37
Fungiacyathus stephanus,19381,13,2,2,17
Polycyathus sp. MFL-2011,15357,13,1,2,16
Porites okinawensis,18647,13,1,2,16
Tubulipora flabellaris,13763,12,22,2,36
Crocodylus acutus,16883,13,22,2,37
Crocodylus intermedius,16828,13,22,2,37
Silurus lanzhouensis,16524,13,22,2,37
Crocodylus novaeguineae,16894,13,22,2,37
Pleuragramma antarctica,18460,13,24,2,39
Chaenocephalus aceratus,17311,13,22,2,37
Saccharina japonica x Saccharina latissima,37638,38,25,3,66
Phytophthora ipomoeae,37872,40,25,2,67
Histiopterus typus,16506,13,22,2,37
Arripis trutta,17244,13,22,2,37
Triturus carnifex,16560,13,22,2,37
Triturus cristatus,16564,13,22,2,37
Triturus dobrogicus,16425,13,22,2,37
Triturus karelinii,16541,13,22,2,37
Nerodia sipedon,17706,13,22,2,37
Triturus macedonicus,16569,13,22,2,37
Triturus marmoratus,16546,13,22,2,37
Triturus pygmaeus,16442,13,22,2,37
Pimelodus pictus,16575,13,22,2,37
Koreocobitis naktongensis,16567,13,22,2,37
Coptotermes formosanus,16326,13,22,2,37
Chilodus punctatus,16869,13,22,2,37
Ficedula zanthopygia,16794,13,22,2,37
Citharinus congicus,16453,13,22,2,37
Silurus asotus,16521,13,22,2,37
Nycticorax nycticorax,17829,13,22,2,37
Synodontis schoutedeni,16540,13,22,2,37
Auchenoglanis occidentalis,16535,13,22,2,37
Garrulus glandarius,16930,13,22,2,37
Bunocephalus coracoideus,16477,13,22,2,37
Python molurus molurus,17258,13,22,2,37
Hydrolycus scomberoides,16548,13,22,2,37
Candida frijolesensis,37215,21,24,2,47
Siniperca scherzeri,16581,13,22,2,37
Hemiodopsis gracilis,16731,13,22,2,37
Hepsetus odoe,16803,13,22,2,37
Siniperca chuatsi,16496,13,22,2,37
Diplomystes nahuelbutaensis,16506,13,22,2,37
Cyanopica cyanus,16893,13,22,2,37
Heteropneustes fossilis,16489,13,22,2,37
Thulinius sp. DVL-2010,15047,13,22,2,37
Malapterurus electricus,16504,13,22,2,37
Sesamia inferens,15413,13,22,2,37
Distichodus sexfasciatus,16555,13,22,2,37
Pareutropius debauwi,16521,13,22,2,37
diploid Xenocypris davidi x Megalobrama amblycephala,16630,13,22,2,37
Pangasius larnaudii,16471,13,22,2,37
Lepus capensis,17722,13,22,2,37
Spilornis cheela,18291,13,22,2,37
Ovis canadensis,16463,13,22,2,37
Oroperipatus sp. DVL-2011,14493,13,21,2,36
Chaetomium thermophilum var. thermophilum DSM 1495,127206,15,28,0,43
Callistoctopus minor,15974,13,22,2,37
Crossoptilon auritum,16687,13,22,2,37
Gracula religiosa,16818,13,22,2,37
Sporothrix schenckii,27125,17,26,2,45
Baylisascaris transfuga,14898,12,22,2,36
Liriomyza sativae,15551,13,22,2,37
Baylisascaris schroederi,14778,12,22,2,36
Thunnus thynnus thynnus,16526,13,22,2,37
Necator americanus,13605,12,22,2,36
Ichthyophthirius multifiliis,51686,41,5,6,52
Sinentomon erythranum,14491,13,22,2,37
Cnaphalocrocis medinalis,15388,13,22,2,37
Siniperca knerii,17002,13,22,2,37
Chelus fimbriata,16661,13,22,2,37
Mytilus californianus,16730,12,23,2,37
Hucho bleekeri,16997,13,22,2,37
Anaticola crassicornis,8118,5,12,2,19
Ibidoecus bisignatus,14908,13,22,2,37
Cucumis sativus,83817,0,0,0,0
Cucumis sativus,44840,0,0,0,0
Manis pentadactyla,16578,13,22,2,37
Beta macrocarpa,385220,156,26,5,187
Cucumis sativus,1555935,37,20,6,63
Panulirus homarus,15665,13,22,2,37
Protantigius superans,15248,13,22,2,37
Stenopirates sp. HL-2011,15384,13,22,2,37
Cigaritis takanonis,15349,13,22,2,37
Dracunculus medinensis,14628,12,29,2,43
Neodon irene,16367,13,22,2,37
Polylabris halichoeres,15527,12,22,2,36
Pelophylax chosenicus,18357,13,22,2,37
Apodemus peninsulae,16269,13,22,2,37
Equus hemionus,16634,13,22,2,37
Lepomis macrochirus,16489,13,22,2,37
Mnemiopsis leidyi,10326,11,0,2,13
Brassica oleracea,360271,77,18,3,98
Nanorana pleskei,17660,13,23,2,38
Brassica carinata,232241,69,17,3,89
Brassica rapa subsp. oleifera,219747,78,18,3,99
Heliconema longissimum,13610,12,22,2,36
Cucullanus robustus,13972,12,22,2,36
Wellcomia siamensis,14128,12,22,2,36
Brassica juncea,219766,78,18,3,99
Chironomus tepperi,15652,13,22,2,37
Leucophytia bidentata,14135,13,22,2,37
Trichocera bimacula,16140,13,22,2,37
Paracladura trichoptera,16143,13,22,2,37
Meretrix lamarckii,21209,13,22,2,37
Ovatella vulcani,14274,13,22,2,37
Sylvicola fenestralis,16234,13,22,2,37
Pedipes pedipes,16708,13,22,2,37
Peronia peronii,13968,13,22,2,37
Pielomastax zhengi,15602,13,22,2,37
Euphausia pacifica,16898,13,22,2,37
Salinator rhamphidia,14007,13,22,2,37
Succinea putris,14092,13,22,2,37
Rhinolophus ferrumequinum korai,16839,13,22,2,37
Trimusculus reticulatus,14044,13,22,2,37
Oxuderces dentatus,17116,13,22,2,37
Ascaris lumbricoides,14281,12,22,2,36
Baylisascaris procyonis,14781,12,22,2,36
Ptychoptera sp. ATB-2011,15214,13,22,2,37
Protoplasa fitchii,16154,13,22,2,37
Cramptonomyia spenceri,16274,13,22,2,37
Arachnocampa flava,16923,13,22,2,37
Penicillium solitum,28601,16,27,2,45
Siphonaria gigas,14518,13,22,2,37
Prionailurus bengalensis euptilurus,16990,13,22,2,37
Yarrowia galli,48508,24,27,2,53
Yarrowia alimentaria,35173,19,24,2,45
Yarrowia deformans,40665,21,26,2,49
Scomberomorus niphonius,16646,13,22,2,37
Oryx gazella,16661,13,22,2,37
Sibynophis collaris,17163,13,22,2,37
Hucho taimen,16833,13,22,2,37
Myodes regulus,16379,13,22,2,37
Apodemus agrarius,16263,13,22,2,37
Leucoraja erinacea,16724,13,22,2,37
Eunapius subterraneus,24850,14,25,2,41
Alloeorhynchus bakeri,15851,13,22,2,37
Clava multicornis,16898,14,2,2,18
Cubaia aphrodite,16148,15,2,2,19
Damaster mirabilissimus mirabilissimus,16823,13,22,2,37
Lutjanus argentimaculatus,16543,13,22,2,37
Apodemus chejuensis,16261,13,22,2,37
Glossogobius olivaceus,16568,13,22,2,37
Solen grandis,16784,12,22,2,36
Pauropus longiramus,14487,13,22,2,37
Crossoptilon crossoptilon,16680,13,22,2,37
Fusarium solani,62978,30,25,2,57
Fusarium verticillioides,53753,21,27,2,50
Pseudois schaeferi,16663,13,22,2,37
Sacalia bealei,16561,13,22,2,37
Trypauchen vagina,16686,13,22,2,37
Amphiprion bicinctus,16645,13,22,2,37
Ctenoptilum vasava,15468,13,24,2,39
Przewalskium albirostris,16478,13,22,2,37
Euploea mulciber,15166,13,22,2,37
Flustra foliacea,16089,13,23,2,38
Mergus squamatus,16595,13,22,2,37
Libythea celtis,15164,13,22,2,37
Fergusonina taylori,16000,13,22,2,37
Sciaenops ocellatus,16500,13,22,2,37
Seriola quinqueradiata,16537,13,22,2,37
Artibeus lituratus,16709,13,22,2,37
Corynorhinus rafinesquii,16438,13,22,2,37
Lasiurus borealis,17048,13,22,2,37
Paphia amabilis,19629,13,23,2,38
Paratapes textilis,18561,13,23,2,38
Paratapes undulatus,18154,13,23,2,38
Labeo catla,16590,13,22,2,37
Polytomella parva,13135,6,1,12,19
Polytomella parva,3018,1,0,0,1
Muntiacus vuquangensis,16361,13,22,2,37
Cambaroides similis,16220,13,22,2,37
Procambarus clarkii,15928,13,22,2,37
Pseudochauhanea macrorchis,15031,12,22,2,36
Emplectonema gracile,14666,13,22,2,37
Peltigera malacea,63363,29,26,2,57
Peltigera membranacea,62785,27,26,2,55
Hiodon alosoides,16619,13,22,2,37
Pagrus auriga,16628,13,22,2,37
Mytilus galloprovincialis,16744,12,23,2,37
Philanthus triangulum,16029,13,22,2,37
Aspergillus fumigatus,30696,19,31,2,52
Phaeodactylum tricornutum,77356,33,24,2,59
Apodemus chevrieri,16298,13,22,2,37
Acetes chinensis,15740,13,23,2,38
Acipenser baerii,16763,13,22,2,37
Cygnus bewickii,16727,13,22,2,37
Dendrophysa russelii,16626,13,22,2,37
Sternotherus carinatus,16554,13,22,2,37
Labeo rohita,16626,13,22,2,37
Argyrosomus japonicus,16496,13,22,2,37
Cirrhinus mrigala,16600,13,22,2,37
Solemya velum,15660,13,22,2,37
Diplogonoporus balaenopterae,13724,12,22,2,36
Labeo calbasu,16596,13,22,2,37
Diplogonoporus grandis,13725,12,22,2,36
Solen strictus,16535,12,22,2,36
Athyma sulpitia,15268,13,22,2,37
Trichuris trichiura,14046,13,22,2,37
Paratemnoides elongatus,14368,13,22,2,37
Gammarus duebeni,15651,13,22,2,37
Uroteuthis edulis,17360,13,22,2,37
Trichuris suis,14436,13,22,2,37
Extatosoma tiaratum,16537,13,22,2,37
Sepiella japonica,16172,13,22,2,37
Chara vulgaris,67737,46,27,3,76
Huso huso,16760,13,22,2,37
Carpiodes carpio,16611,13,22,2,37
Cyanophora paradoxa,51557,44,30,3,77
Helicosporidium sp. ex Simulium jonesi,49343,37,25,3,65
Samia ricini,15384,13,22,2,37
Cylindrus obtusus,14610,13,22,2,37
Nectonemertes cf. mirabilis HC-2011,15365,13,22,2,37
Agonostomus monticola,16734,13,22,2,37
Zygeupolia rubens,15513,13,22,2,37
Cuora picturata,16623,13,22,2,37
Aldrichetta forsteri,16797,13,22,2,37
Bostrychus sinensis,16508,13,22,2,37
Chaenomugil proboscideus,16666,13,22,2,37
Chiloscyllium griseum,16755,13,22,2,37
Chelon labrosus,16898,13,22,2,37
Crenimugil crenilabis,16888,13,22,2,37
Cuora bourreti,16649,13,22,2,37
Planiliza affinis,16835,13,22,2,37
Mugil curema,16828,13,22,2,37
Pseudomyxus capensis,17132,13,22,2,37
Oedalechilus labeo,17216,13,22,2,37
Squalomugil nasutus,16974,13,22,2,37
Minimugil cascasia,17119,13,22,2,37
Trachinops taeniatus,16821,13,22,2,37
Rafetus swinhoei,16990,13,22,2,37
Inia geoffrensis,16588,13,22,2,37
Phocoena phocoena,16382,13,22,2,37
Eschrichtius robustus,16412,13,22,2,37
Balaena mysticetus,16390,13,22,2,37
Caperea marginata,16383,13,22,2,37
Lagenorhynchus albirostris,16393,13,22,2,37
Kogia breviceps,16406,13,22,2,37
Monodon monoceros,16383,13,22,2,37
Pontoporia blainvillei,16593,13,22,2,37
Berardius bairdii,16346,13,22,2,37
Hyperoodon ampullatus,16346,13,22,2,37
Platanista minor,16324,13,22,2,37
Spirodela polyrhiza,228493,35,19,3,57
Fusarium oxysporum,34477,16,25,2,43
Melitaea cinxia,15170,13,22,2,37
Tetrancistrum nebulosi,13392,12,22,2,36
Hydropotes inermis argyropus,16356,13,22,2,37
Tetraophasis obscurus,16707,13,22,2,37
Cyprinus carpio carpio,16581,13,22,2,37
Cyprinus carpio 'xingguonensis',16581,13,22,2,37
Cyprinus carpio haematopterus,16581,13,22,2,37
Cyprinus carpio 'wuyuanensis',16582,13,22,2,37
Papilio bianor,15340,13,22,2,37
Blastocystis sp. subtype 3,28269,27,16,0,43
Onychostoma lini,16595,13,22,2,37
Papilio machaon,15185,13,22,2,37
Ochlodes venata,15622,13,23,2,38
Celastrina hersilia,15302,13,22,2,37
Panthera leo persica,16818,13,22,2,37
Stiphodon alcedo,16505,13,22,2,37
Rhinopithecus brelichi,16553,13,22,2,37
Rhinopithecus bieti 1 RL-2012,16550,13,22,2,37
Rhinopithecus strykeri,16550,13,22,2,37
Rhinopithecus bieti 2 RL-2012,16550,13,22,2,37
Pygathrix nigripes,16536,13,22,2,37
Pygathrix cinerea 1 RL-2012,16535,13,22,2,37
Pygathrix cinerea 2 RL-2012,16535,13,22,2,37
Erythranthe guttata,525671,41,24,4,69
Thitarodes renzhiensis,16173,13,22,2,37
Ahamus yunnanensis,15816,13,22,2,37
Saimiri boliviensis boliviensis,16473,13,22,2,37
Stenopus hispidus,15528,13,23,2,38
Eospalax fontanierii baileyi,16351,13,22,2,37
Gobiocypris rarus,16601,13,22,2,37
Ornithodoros capensis,14418,13,22,2,37
Haemaphysalis flava,14686,13,22,2,37
Ixodes holocyclus,15007,13,22,2,37
Vargula hilgendorfii,15923,13,22,2,37
Dirofilaria immitis,13814,12,22,2,36
Auxis thazard,16506,13,22,2,37
Auxis rochei,16501,13,22,2,37
Nannospalax ehrenbergi,16408,13,22,2,37
Ophiopholis aculeata,16472,13,22,2,37
Lampsilis ornata,16060,13,22,2,37
Emiliania huxleyi,29013,21,25,2,48
Sebastes schlegelii,16525,13,22,2,37
Acipenser dabryanus,16438,13,22,2,37
Sorex unguiculatus,17105,13,22,2,37
Tricholepidion gertschi,15267,13,22,2,37
Pipistrellus abramus,16976,13,22,2,37
Rhinolophus pumilus,16869,13,22,2,37
Gomphiocephalus hodgsoni,15075,13,22,2,37
Rhinolophus monoceros,16851,13,22,2,37
Eremothecium gossypii ATCC 10895,23564,8,23,2,33
Drosophila sechellia,14950,13,22,2,37
Acipenser stellatus,16537,13,22,2,37
Elops saurus,16120,13,22,2,37
Megalops atlanticus,16686,13,22,2,37
Megalops cyprinoides,16412,13,22,2,37
Synaphobranchus kaupii,16166,13,22,2,37
Ophisurus macrorhynchos,17843,13,22,2,37
Aldrovandia affinis,16649,13,22,2,37
Ambystoma mexicanum,16369,13,22,2,37
Elops hawaiensis,16713,13,22,2,37
Pterothrissus gissu,16188,13,22,2,37
Ornithodoros porcinus,14378,13,22,2,37
Rhyncholestes raphanurus,16727,13,22,2,37
Dromiciops gliroides,15350,13,21,2,36
Thylamys elegans,15452,13,21,2,36
Caenolestes fuliginosus,16629,13,22,2,37
Psephurus gladius,16483,13,22,2,37
Mola mola,16488,13,22,2,37
Masturus lanceolatus,16481,13,22,2,37
Apteryx haastii,16980,13,22,2,37
Tinamus major,16701,13,22,2,37
Siphonodentalium lobatum,13932,13,22,2,37
Eudromia elegans,18305,13,22,2,37
Scutigera coleoptrata,14922,13,22,2,37
Tetraclita japonica,15194,13,22,2,37
Cherax destructor,15894,13,22,2,37
Etheostoma radiosum,16600,13,22,2,37
Casuarius casuarius,16756,13,22,2,37
Anseranas semipalmata,16870,13,22,2,37
Cucumaria miniata,17538,13,22,2,37
Haplopelma schmidti,13874,13,22,2,37
Aleurodicus dugesii,15723,13,20,2,35
Steinernema carpocapsae,13925,12,22,2,36
Haliotis rubra,16907,13,22,2,37
Ninox novaeseelandiae,16223,13,22,2,37
Strigops habroptila,15599,13,22,2,37
Xibalbanus tulumensis,18372,13,23,2,38
Habronattus oregonensis,14381,13,22,2,37
Moniliophthora perniciosa,109103,89,26,2,117
Xiphinema americanum,12626,12,19,2,33
Songthela hangzhouensis,14215,13,22,2,37
Ophiura luetkenii,17329,13,22,2,37
Argulus americanus,15102,13,22,2,37
Sceloporus occidentalis,17072,13,22,2,37
Shinisaurus crocodilurus,16583,13,22,2,37
Rena humilis,16218,13,22,2,37
Smaug warreni,17184,13,24,2,39
Abronia graminea,16016,13,22,2,37
Amblyomma triguttatum,14740,13,22,2,37
Starmerella bacillaris,23114,15,25,2,42
Kluyveromyces lactis,40291,9,22,2,33
Periplaneta fuliginosa,14996,13,22,2,37
Podura aquatica,13809,13,20,1,34
Triops longicaudatus,15111,13,22,2,37
Ixodes uriae,15053,13,22,2,37
Thermobia domestica,15152,13,22,2,37
Onychiurus orientalis,12984,13,20,1,34
Paraspadella gotoi,11423,11,1,2,14
Acanthogobius hasta,16663,13,22,2,37
Carassius auratus x Cyprinus carpio,16580,13,22,2,37
Taenia asiatica,13703,12,22,2,36
Schizaphis graminum,15721,13,22,2,37
Graptacme eborea,14492,13,22,2,37
Callinectes sapidus,16263,13,22,2,37
Bipes biporus,16412,13,24,2,39
Trialeurodes vaporariorum,18414,13,22,2,37
Diplometopon zarudnyi,16730,13,22,2,37
Carassius carassius,16580,13,22,2,37
Geocalamus acutus,16659,13,22,2,37
Rhineura floridana,16988,13,22,2,37
Megabalanus volcano,15107,13,22,2,37
Tetraleurodes acaciae,15080,13,19,2,34
Amphisbaena schmidti,17423,13,22,2,37
Bipes tridactylus,16222,13,22,2,37
Bipes canaliculatus,16200,13,22,2,37
Ichthyophis glutinosus,15986,13,22,2,37
Gegeneophis ramaswamii,15897,13,21,2,36
Scolecomorphus vittatus,15973,13,22,2,37
Uraeotyphlus cf. oxyurus MW-212,16432,13,22,2,37
Clymenella torquata,15538,13,22,2,37
Ambystoma laterale,16367,13,22,2,37
Plethodon elongatus,18767,13,22,2,37
Desmognathus fuscus,16628,13,22,2,37
Desmognathus wrighti,16578,13,22,2,37
Phaeognathus hubrichti,16294,13,22,2,37
Batrachoseps wrighti,19789,13,22,2,37
Ensatina eschscholtzii,22816,13,22,2,37
Hydromantes brunus,17220,13,22,2,37
Oedipina poelzi,16731,13,22,2,37
Eurycea bislineata,17184,13,22,2,37
Gyrinophilus porphyriticus,16778,13,22,2,37
Pseudotriton ruber,16661,13,22,2,37
Aneides flavipunctatus,20197,13,22,2,37
Aneides hardii,22184,13,25,2,40
Batrachoseps attenuatus,17559,13,22,2,37
Thorius n. sp. RLM-2004,19097,13,22,2,37
Bolitoglossa n. sp. RLM-2004,21657,13,22,2,37
Stereochilus marginatus,19631,13,22,2,37
Rhyacotriton variegatus,21606,13,23,2,38
Hemidactylium scutatum,17421,13,22,2,37
Chlorurus sordidus,16681,13,22,2,37
Todarodes pacificus,20254,18,22,2,42
Zaglossus bruijni,16367,13,22,2,37
Dermatobia hominis,16360,13,23,2,38
Urechis caupo,15113,13,22,2,37
Pangasianodon gigas,16533,13,22,2,37
Carassius auratus x Cyprinus carpio x Carassius cuvieri,16581,13,22,2,37
Scomber scombrus,16560,13,22,2,37
Ichthyophis bannanicus,15983,13,22,2,37
Myxocyprinus asiaticus,16636,13,22,2,37
Microhyla heymonsi,16707,13,22,2,37
Paramesotriton hongkongensis,16285,13,22,2,37
Hyla chinensis,18180,13,22,2,37
Kaloula pulchra,16818,13,22,2,37
Asymmetron lucayanum,15102,13,22,2,37
Epigonichthys maldivensis,14975,13,22,2,37
Potorous tridactylus,16922,13,22,2,37
Pseudocheirus peregrinus,16022,13,22,2,37
Notoryctes typhlops,15923,13,21,2,36
Tarsipes rostratus,15744,13,22,2,37
Metachirus nudicaudatus,15882,13,22,2,37
Sminthopsis douglasi,16538,13,22,2,37
Macrotis lagotis,15289,13,21,2,36
Phascogale tapoatafa,17405,13,22,2,37
Anguilla marmorata,16745,13,22,2,37
Anguilla celebesensis,16700,13,22,2,37
Anguilla mossambica,16694,13,22,2,37
Anguilla reinhardtii,16690,13,22,2,37
Anguilla bicolor bicolor,16700,13,22,2,37
Anguilla dieffenbachii,16687,13,22,2,37
Anguilla australis australis,16686,13,22,2,37
Anguilla australis schmidti,16682,13,22,2,37
Anguilla megastoma,16714,13,22,2,37
Anguilla obscura,16704,13,22,2,37
Anguilla nebulosa nebulosa,16707,13,22,2,37
Anguilla interioris,16713,13,22,2,37
Anguilla malgumora,16550,13,22,2,37
Anguilla labiata,16833,13,22,2,37
Carassius auratus auratus,16580,13,22,2,37
Nicotiana tabacum,430597,156,23,4,183
Lachancea thermotolerans,23584,11,24,3,38
Asterias amurensis,16427,13,19,0,32
Astropecten polyacanthus,16304,13,19,0,32
Luidia quinaria,16524,13,19,0,32
Gryllotalpa orientalis,15521,13,22,2,37
Alytes obstetricans pertinax,17490,13,22,2,37
Bombina orientalis,17847,13,22,2,37
Discoglossus galganoi,17014,13,22,2,37
Balaenoptera physalus,16398,13,22,2,37
Ascaris suum,14284,12,22,2,36
Paracentrotus lividus,15696,13,22,2,37
Balaenoptera musculus,16402,13,22,2,37
Halichoerus grypus,16797,13,22,2,37
Didelphis virginiana,17084,13,22,2,37
Patiria pectinifera,16260,13,22,2,37
Pongo pygmaeus,16389,13,22,2,37
Protopterus dolloi,16646,13,22,2,37
Locusta migratoria migratorioides,15722,13,22,2,37
Formosania lacustris,16558,13,22,2,37
Albinaria caerulea,14130,13,22,2,37
Polypterus ornatipinnis,16624,13,22,2,37
Rhinoceros unicornis,16829,13,22,2,37
Osphranter robustus,16896,13,22,2,37
Florometra serratissima,16005,13,22,2,37
Balanoglossus carnosus,15708,13,22,2,37
Glis glis,16602,13,22,2,37
Rhea americana,16714,13,22,2,37
Branchiostoma lanceolatum,15076,13,22,2,37
Lycodon semicarinatus,17191,13,23,2,38
Pelomedusa subrufa,16787,13,22,2,37
Scyliorhinus canicula,16697,13,22,2,37
Papio hamadryas,16521,13,22,2,37
Artibeus jamaicensis,16651,13,22,2,37
Ixodes hexagonus,14539,13,22,2,37
Rhipicephalus sanguineus,14710,13,22,2,37
Hylobates lar,16472,13,22,2,37
Daphnia pulex,15333,13,22,2,37
Salvelinus fontinalis,16624,13,22,2,37
Aythya americana,16616,13,22,2,37
Smithornis sharpei,17344,13,22,2,37
Vidua chalybeata,16895,13,22,2,37
Plestiodon egregius,17407,13,22,2,37
Hippopotamus amphibius,16407,13,22,2,37
Mustelus manazo,16707,13,22,2,37
Amblyraja radiata,16783,13,22,2,37
Trachurus trachurus,16559,13,22,2,37
Zancudomyces culisetae,58654,31,27,2,60
Rhizopus oryzae,54178,24,24,2,50
Podila verticillata,58745,25,26,2,53
Urva javanica,16763,13,22,2,37
Heterostelium pallidum,47653,42,19,2,63
Platynereis dumerilii,15619,13,22,2,37
Metridium senile,17443,14,2,2,18
Macrobrachium rosenbergii,15772,13,22,2,37
Centruroides limpidus,14519,13,21,2,36
Colobus guereza,16648,13,22,2,37
Ambystoma californiense,16374,13,22,2,37
Ambystoma tigrinum,16375,13,22,2,37
Trachypithecus obscurus,16560,13,22,2,37
Leptorhynchoides thecatus,13888,12,24,2,38
Oncorhynchus clarkii henshawi,16658,13,22,2,37
Axinella corrugata,25610,14,25,2,41
Homalodisca vitripennis,15304,13,22,2,37
Pseudocarcinus gigas,15515,13,22,2,37
Montipora cactus,17887,13,2,2,17
Ambystoma andersoni,16370,13,22,2,37
Ambystoma dumerilii,16370,13,22,2,37
Nesomachilis australica,15474,13,21,2,36
Anacropora matthai,17888,13,2,2,17
Balaenoptera borealis,16410,13,22,2,37
Megaptera novaeangliae,16398,13,22,2,37
Choloepus didactylus,16543,13,22,2,37
Balaenoptera bonaerensis,16421,13,22,2,37
Mus musculus molossinus,16300,13,22,2,37
Mystacina tuberculata,16784,13,22,2,37
Eubalaena australis,16385,13,22,2,37
Jenkinsia lamprotaenia,16784,13,22,2,37
Salanx ariakensis,16587,13,22,2,37
Sundasalanx mekongensis,16736,13,22,2,37
Balaenoptera brydei,16408,13,22,2,37
Harpiosquilla harpax,15714,13,22,2,37
Eubalaena japonica,16386,13,22,2,37
Cervus nippon yesoensis,16543,13,22,2,37
Candida orthopsilosis,22528,15,24,2,41
Candida metapsilosis,24152,15,24,2,41
Geodia neptuni,18020,14,24,2,40
Eriocheir sinensis,16354,13,22,2,37
Cervus nippon centralis,16663,13,22,2,37
Tethya actinia,19565,14,25,2,41
Branta canadensis,16760,13,22,2,37
Chlorocebus aethiops,16389,13,22,2,37
Penaeus japonicus,15968,13,22,2,37
Larus dominicanus,16701,13,22,2,37
Terebratulina retusa,15451,13,22,2,37
Lampetra fluviatilis,16159,13,22,2,37
Haematobia irritans irritans,16078,13,22,2,37
Aphrodroma brevirostris,16414,13,22,2,37
Zhangixalus schlegelii,21359,13,22,2,37
Okamejei kenojei,16972,13,22,2,37
Cervus nippon yakushimae,16440,13,22,2,37
Leptotrombidium pallidum,16779,13,22,3,38
Japyx solifugus,15785,13,22,2,37
Placopecten magellanicus,32115,12,32,2,46
Oreochromis mossambicus,16641,13,22,2,37
Gallus lafayettii,16841,13,22,2,37
Gallus sonneratii,16841,13,22,2,37
Gallus varius,16783,13,22,2,37
Alectura lathami,16698,13,22,2,37
Cobitis sinensis,16553,13,22,2,37
Plesiobatis daviesi,17514,13,22,2,37
Plasmodium knowlesi,5957,3,0,0,3
Plasmodium simium,5990,3,0,0,3
Phytophthora infestans,37957,40,25,2,67
Talpa europaea,16884,13,22,2,37
Echinococcus multilocularis,13738,12,22,2,36
Pupa strigosa,14189,13,22,2,37
Halocynthia roretzi,14771,12,23,2,37
Penaeus monodon,15984,13,22,2,37
Geothelphusa dehaani,18197,13,23,2,38
Melanogrammus aeglefinus,16585,13,22,2,37
Boa constrictor,18905,13,22,2,37
Epidermophyton floccosum,30910,24,25,2,51
Acrochordus granulatus,17604,13,22,2,37
Python regius,17245,13,22,2,37
Cylindrophis ruffus,17499,13,22,2,37
Xenopeltis unicolor,18872,13,22,2,37
Merlangius merlangus,16569,13,22,2,37
Thalassiosira pseudonana,43827,35,25,2,62
Cypselurus hiraii,16528,13,22,2,37
Ovophis okinavensis,17388,13,22,2,37
Dictyostelium discoideum,55564,42,18,2,62
Ciconia ciconia,17347,13,22,2,37
Ciconia boyciana,17622,13,22,2,37
Aspergillus niger,31103,16,25,2,43
Squilla empusa,15828,13,22,2,37
Gonodactylus chiragra,16279,13,22,2,37
Andrias japonicus,16298,13,22,2,37
Aspergillus tubingensis,33656,16,25,2,43
Nisaetus nipalensis,17667,13,22,2,37
Leptotrombidium deliense,13731,13,22,2,37
Leptotrombidium akamushi,13698,13,22,2,37
Nisaetus alboniger,17977,13,22,2,37
Dasyurus hallucatus,17159,13,22,2,37
Sminthopsis crassicaudata,17363,13,22,2,37
Gekko gecko,16435,13,22,2,37
Cathartes aura,16779,13,22,2,37
Echymipera rufescens australis,16642,13,22,2,37
Laqueus rubellus,14017,13,22,2,37
Mytilus trossulus,18652,12,24,2,38
Rangifer tarandus,16362,13,22,2,37
Petrobius brevistylis,15698,13,22,2,37
Stigmochelys pardalis,19403,13,22,2,37
Indotestudo elongata,16788,13,22,2,37
Testudo graeca,19278,13,22,2,37
Testudo horsfieldii,17093,13,22,2,37
Testudo kleinmanni,17670,13,22,2,37
Testudo marginata,19438,13,22,2,37
Cygnus columbianus,16728,13,22,2,37
Neogymnocrinus richeri,15966,13,22,2,37
Sclerophasma paresisense,15500,13,22,2,37
Indotestudo forstenii,16952,13,22,2,37
Manouria emys,16455,13,22,2,37
Tamolanica tamolana,16055,13,22,2,37
Malacochersus tornieri,19202,13,23,2,38
Phanogenia gracilis,15892,13,22,2,37
Dictyota dichotoma,31617,38,24,3,65
Fucus vesiculosus,36392,38,25,3,66
Desmarestia viridis,39049,39,25,3,67
Sciurus vulgaris,16507,13,22,2,37
Hanseniaspora uvarum,18844,8,23,2,33
Tritia obsoleta,15263,13,22,2,37
Lottia digitalis,26835,13,20,2,35
Acanthaster brevispinus,16254,13,22,2,37
Typhlonectes natans,17005,13,22,2,37
Sepia officinalis,16163,13,22,2,37
Sepioteuthis lessoniana,16631,13,22,2,37
Menura novaehollandiae,17839,13,22,2,37
Mantella madagascariensis,22874,13,23,2,38
Phractolaemus ansorgii,16511,13,22,2,37
Ranzania laevis,16478,13,22,2,37
Rhodeus uyekii,16817,13,22,2,37
Oryza sativa Indica Group,491515,54,33,6,93
Watasenia scintillans,20093,18,23,2,43
Amphioctopus fangsiao,15979,13,22,2,37
Siphonops annulatus,16202,13,22,2,37
Anisakis simplex,13916,12,22,2,36
Balaenoptera edeni,16409,13,22,2,37
Verasper variegatus,17273,13,22,2,37
Paracoccidioides brasiliensis,71335,17,25,2,44
Orbinia latreillii,15558,13,22,2,37
Balaenoptera omurai,16404,13,22,2,37
Physcomitrium patens,105340,42,24,3,69
Platysternon megacephalum,19043,13,22,2,37
Synthliboramphus antiquus,16730,13,22,2,37
Nautilus macromphalus,16258,13,21,2,36
Phaethon rubricauda,17777,13,22,2,37
Cnemotriccus fuscatus,17171,13,22,2,37
Coreana raphaelis,15314,13,23,2,38
Heterololigo bleekeri,17211,13,22,2,37
Thaumamermis cosgrovei,20013,12,25,3,40
Strelkovimermis spiculatus,18030,12,25,4,41
Tupaia belangeri,16754,13,22,2,37
Rattus norvegicus,16300,13,22,2,37
Porphyra umbilicalis,29123,26,24,2,52
Chandlerella quiscali,13757,12,22,2,36
Euphlyctis hexadactylus,20280,13,23,2,38
Tachysurus vachellii,16527,13,22,2,37
Phialocephala subalpina,43742,21,28,2,51
Porotermes adamsoni,16039,13,22,2,37
Aspergillus oryzae 3.042,29192,14,10,0,24
Microhodotermes viator,15704,13,22,2,37
Zootermopsis angusticollis,15483,13,22,2,37
Neotermes insularis,15799,13,22,2,37
Coptotermes lacteus,16326,13,22,2,37
Schedorhinotermes breinli,15864,13,22,2,37
Heterotermes sp. SLC-2012,16370,13,22,2,37
Macrotermes subhyalinus,16351,13,22,2,37
Drepanotermes sp. SLC-2012,16542,13,22,2,37
Macrognathotermes errator,16330,13,22,2,37
Nasutitermes triodiae,15849,13,22,2,37
Cryptocercus relictus,15373,13,22,2,37
Raphanus sativus,258426,35,18,3,56
Malus domestica,396947,33,20,4,57
Accipiter gentilis,18266,13,22,2,37
Tachysurus nitidus,16532,13,22,2,37
Pungitius sinensis,16581,13,22,2,37
Pungitius kaibarae,16505,13,22,2,37
Chrysoperla nipponensis,16057,13,22,2,37
Apochrysa matsumurae,16214,13,22,2,37
Marssonina brunnea f. sp. 'multigermtubi',70379,11,21,0,32
Onchocerca flexuosa,13672,12,22,2,36
Wuchereria bancrofti,13636,12,22,2,36
Kallima inachus,15183,13,22,2,37
Acanthocheilonema viteae,13724,12,22,2,36
Sillago sihama,16599,13,22,2,37
Gigaspora rosea,97350,22,25,3,50
Scartelaos histophorus,16496,13,22,2,37
Mastotermes darwiniensis,15487,13,22,2,37
Hemibarbus maculatus,16611,13,22,2,37
Eospalax rothschildi,16377,13,22,2,37
Galba pervia,13768,13,22,2,37
Challia fletcheri,20456,13,22,2,37
Rhinolophus luctus,16775,13,22,2,37
Hipposideros armiger,16784,13,22,2,37
Alulatettix yunnanensis,15104,13,22,2,37
Tetrix japonica,15128,13,22,2,37
Oryzias melastigma,16864,13,22,2,37
Natator depressus,16281,13,22,2,37
Acanthopagrus schlegelii,16649,13,22,2,37
Sahyadria chalakkudiensis,16989,13,22,2,37
Cervus nippon sichuanicus,16429,13,22,2,37
Kobus leche,16426,13,22,2,37
Carassius cuvieri,16581,13,22,2,37
Porites porites,18648,13,2,2,17
Plectropomus leopardus,16714,13,22,2,37
Culicoides arakawae,18135,13,22,2,37
Mussa angulosa,17245,13,2,2,17
Siderastrea radians,19387,13,2,2,17
Colpophyllia natans,16906,13,2,2,17
Lyciasalamandra atifi,16650,13,22,2,37
Nomascus gabriellae,16478,13,22,2,37
Koreocobitis rotundicaudata,16571,13,22,2,37
Xenopus borealis,17474,13,22,2,37
Protopterus annectens,16657,13,22,2,37
Glossogobius circumspectus,16573,13,22,2,37
Sarcophilus harrisii,17117,13,22,2,37
Plasmodium mexicanum,5991,3,0,0,3
Plasmodium floridense,6002,3,0,0,3
Acleris fimbriana,15933,13,22,2,37
Xenopus victorianus,17716,13,22,2,37
Bactrocera correcta,15936,13,22,2,37
Paraminabea aldersladei,19886,14,1,2,17
Phoronopsis harmeri,15495,13,22,2,37
Crassostrea sp. DB1,22040,15,23,4,42
Xizicus fascipes,16166,13,22,2,37
Neochauliodes punctatolosus,15734,13,22,2,37
Globicephala melas,16390,13,22,2,37
Agaricia humilis,18735,13,2,2,17
Pavonia clavus,18315,13,2,2,17
Rhodactis sp. CASIZ 171755,20093,13,2,2,17
Discosoma sp. CASIZ 168915,20908,13,2,2,17
Discosoma sp. CASIZ 168916,20912,13,2,2,17
Astrangia sp. JVK-2006,14853,13,2,2,17
Labracinus cyclophthalmus,15713,13,22,2,37
Denticeps clupeoides,17156,13,22,2,37
Grasseichthys gabonensis,16867,13,22,2,37
Kneria sp. SL-2004,16428,13,22,2,37
Parakneria cameronensis,16619,13,22,2,37
Pseudorca crassidens,16392,13,22,2,37
Trachypithecus hatinhensis,16547,13,22,2,37
Trachypithecus germaini,16552,13,22,2,37
Trachypithecus shortridgei,16529,13,22,2,37
Trachypithecus johnii,16544,13,22,2,37
Orcaella heinsohni,16389,13,22,2,37
Trachypithecus vetulus,16554,13,22,2,37
Apodemus draco,16282,13,22,2,37
Apodemus latronum,16288,13,22,2,37
Feresa attenuata,16387,13,22,2,37
Peponocephala electra,16388,13,22,2,37
Orcaella brevirostris,16383,13,22,2,37
Phoxinus keumkang,16604,13,22,2,37
Hoplobatrachus rugulosus,20309,14,23,2,39
Theropithecus gelada,16546,13,22,2,37
Chrysomya megacephala,15273,13,23,2,38
Chrysomya rufifacies,15412,13,23,2,38
Hapalogenys analis,16339,13,21,2,36
Aotus lemurinus,16580,13,22,2,37
Ateles belzebuth,16560,13,22,2,37
Plecturocebus donacophilus,16563,13,22,2,37
Lysiosquillina maculata,16325,13,22,2,37
Neotetracus sinensis,16982,13,22,2,37
Lucilia cuprina,15952,13,22,2,37
Gymnocypris przewalskii ganzihonensis,16682,13,22,2,37
Gymnocypris eckloni,16686,13,22,2,37
Chrysopa pallens,16723,13,22,2,37
Rhyacionia leptotubula,15877,13,22,2,37
Bunostomum trigonocephalum,13764,12,22,2,36
Macracanthorhynchus hirudinaceus,14282,12,22,2,36
Nuttalliella namaqua,14425,13,22,2,37
Echinorhynchus truttae,13659,10,15,2,27
Paratenuisentis ambiguus,13574,12,21,2,35
Metacrangonyx repens,14355,13,22,2,37
Metacrangonyx dominicanus,14543,13,22,2,37
Metacrangonyx goulmimensis,14507,13,22,2,37
Metacrangonyx ilvanus,14770,13,22,2,37
Metacrangonyx spinicaudatus,15037,13,22,2,37
Metacrangonyx longicaudus,14711,13,22,2,37
Metacrangonyx panousei,14478,13,22,2,37
Metacrangonyx remyi,14787,13,22,2,37
Triplophysa rosa,16585,13,22,2,37
Hemibagrus macropterus,16530,13,22,2,37
Gorpis humeralis,18165,13,22,2,37
Nabis apicalis,15588,13,19,2,34
Gorpis annulatus,16660,13,22,2,37
Crotaphatrema lamottei,17103,13,24,2,39
Neosalanx taihuensis,16549,13,22,2,37
Onychostoma barbatum,16592,13,22,2,37
Chrysomya albiceps,15491,13,23,2,38
Chrysomya bezziana,15236,13,23,2,38
Chrysomya saffranea,15839,13,23,2,38
Protophormia terraenovae,15170,13,22,2,37
Lucilia porphyrina,15877,13,22,2,37
Hemipyrellia ligurriens,15938,13,22,2,37
Calliphora vicina,16112,13,22,2,37
Rutilia goerlingiana,15331,13,22,2,37
Odontamblyopus rubicundus,17119,13,22,2,37
Squaliobarbus curriculus,16619,13,22,2,37
Austinogebia edulis,15761,13,22,2,37
Upogebia major,16143,13,22,2,37
Thalassina kelanang,15528,13,22,2,37
Neaxius glyptocercus,14909,13,22,2,37
Nihonotrypaea thermophila,15240,13,22,2,37
Argas africolumbae,14440,13,22,2,37
Neophema chrysogaster,18043,13,22,2,37
Nesopsar nigerrimus,16780,13,22,2,37
Gnorimopsar chopi,16775,13,22,2,37
Chrysomus ruficapillus,16773,13,22,2,37
Oreopsar bolivianus,16777,13,22,2,37
Agelasticus xanthophthalmus,16769,13,22,2,37
Chrysomus icterocephalus,16773,13,22,2,37
Dives dives,16766,13,22,2,37
Agelaius phoeniceus,16775,13,22,2,37
Amblyramphus holosericeus,16768,13,22,2,37
Quiscalus quiscula,16768,13,22,2,37
Xanthopsar flavus,16773,13,22,2,37
Pseudoleistes virescens,16769,13,22,2,37
Molothrus aeneus,16757,13,22,2,37
Agelasticus thilius,16771,13,22,2,37
Curaeus curaeus,16771,13,22,2,37
Pseudoleistes guirahuro,16770,13,22,2,37
Macroagelaius imthurni,16768,13,22,2,37
Agelaioides badius,16774,13,22,2,37
Gymnomystax mexicanus,16781,13,22,2,37
Agelasticus cyanopus,16771,13,22,2,37
Euphagus cyanocephalus,16765,13,22,2,37
Phalera flavescens,15659,13,22,2,37
Oryx dammah,16756,13,22,2,37
Epinephelus awoara,16802,13,22,2,37
Alvinocaris chelys,15910,13,22,2,37
Neoporphyra haitanensis,37023,28,24,2,54
Schizothorax biddulphi,16585,13,22,2,37
Acentrogobius pflaumii,16515,13,22,2,37
Brachymystax lenok,16832,13,22,2,37
Brachymystax lenok tsinlingensis,16669,13,22,2,37
Celleporella hyalina,17265,13,22,2,37
Bahaba taipingensis,16500,13,22,2,37
Sphaerotheriidae sp. HYS-2012,14970,13,22,2,37
Perna viridis,16014,13,23,2,38
Babina adenopleura,18982,13,22,2,37
Nannochloropsis gaditana,42213,33,0,0,33
Bombina fortinuptialis,17575,13,22,2,37
Ceracris kiangsu,15665,13,22,2,37
Sinocyclocheilus furcodorsalis,16581,13,22,2,37
Heleophryne regis,17620,13,22,2,37
Lechriodus melanopyga,19205,13,22,2,37
Sooglossus thomasseti,16407,13,22,2,37
Moschus anhuiensis,16351,13,22,2,37
Acanthurus leucosternon,16434,13,22,2,37
Choristoneura longicellana,15759,13,22,2,37
Pseudopentaceros richardsoni,16511,13,22,2,37
Telmatobius bolivianus,19295,13,22,2,37
Cydia pomonella,15253,13,22,2,37
Halicryptus spinulosus,14732,13,22,2,37
Homatula variegata,16571,13,22,2,37
Pongamia pinnata,425718,37,24,3,64
Lotus japonicus,380861,34,20,3,57
Triplophysa stoliczkai,16571,13,22,2,37
Cyprinus carpio 'color',16581,13,22,2,37
Blattella bisignata,16470,13,22,2,37
Percocypris pingi,16586,13,22,2,37
Tachysurus eupogon,16562,13,22,2,37
Triplophysa bleekeri,16568,13,22,2,37
Takydromus wolteri,18236,13,22,2,37
Mobula japanica,18880,13,22,2,37
Megophrys shapingensis,17631,13,22,2,37
Aphyocypris kikuchii,16601,13,22,2,37
Spodoptera exigua,15365,13,22,2,37
Reclinomonas americana,69034,67,26,4,97
Pneumocystis murina,24608,15,28,2,45
Microbotryum lychnidis-dioicae,107808,51,31,1,83
Microbotryum cf. violaceum BFL-2013,92107,44,24,1,69
Cantharellus cibarius,58656,33,26,2,61
Nuclearia simplex,74129,40,25,2,67
Ceratocystis cacaofunesta,103147,52,31,2,85
Ministeria vibrans,55918,33,25,2,60
Boulengerula boulengeri,15973,13,22,2,37
Boulengerula taitana,16587,13,23,2,38
Hippocampus comes,16525,13,22,2,37
Urocissa erythroryncha,16930,13,22,2,37
Leiothrix lutea,17615,13,22,2,37
Garrulax canorus,17785,13,22,2,37
Equus kiang,16380,13,22,2,37
Blicca bjoerkna,16605,13,22,2,37
Abramis brama,16607,13,22,2,37
Phoxinus phoxinus,17859,13,22,2,37
Pteromys volans,16513,13,22,2,37
Fissurella volcano,17575,13,23,2,38
Caecilia volcani,16187,13,22,2,37
Dermophis mexicanus,16162,13,22,2,37
Gymnopis multiplicata,16134,13,22,2,37
Hypogeophis rostratus,16151,13,22,2,37
Microcaecilia sp. PZ-2009,16180,13,22,2,37
Oscaecilia ochrocephala,16238,13,22,2,37
Urochela quadrinotata,16587,13,20,2,35
Geotrypetes seraphini,16293,13,22,2,37
Hackeriella veitchi,15793,13,22,2,37
Rimicaris kairei,15900,13,22,2,37
Opaepele loihi,15905,13,22,2,37
Austinograea rodriguezensis,15611,13,22,2,37
Austinograea alayseae,15620,13,22,2,37
Phyxioschema suthepium,13931,13,22,2,37
Liphistius erawan,14197,13,22,2,37
Pholcus phalangioides,14459,13,22,2,37
Rhinolophus ferrumequinum quelpartis,16870,13,22,2,37
Leucaspius delineatus,16602,13,22,2,37
Heliopora coerulea,18957,14,1,2,17
Gracupica nigricollis,16839,13,22,2,37
Oriolus chinensis,16803,13,22,2,37
Delias hyparete,15186,13,22,2,37
Paedocypris progenetica,17382,13,22,2,37
Papio cynocephalus,16515,13,22,2,37
Papio kindae,16504,13,22,2,37
Papio papio,16505,13,22,2,37
Papio ursinus,16496,13,22,2,37
Atrina pectinata,16811,12,21,2,35
Ommastrephes bartramii,20308,18,23,2,43
Helicolenus avius,16651,13,22,2,37
Gonium pectorale,15993,8,4,12,24
Brachyhypopomus occidentalis,16542,13,22,2,37
Heterotis niloticus,16551,13,22,2,37
Hiodon tergisus,16620,13,22,2,37
Genyomyrus donnyi,16697,13,22,2,37
Marcusenius senegalensis,16691,13,22,2,37
Petrocephalus soudanensis,16961,13,22,2,37
Petrocephalus microphthalmus,17124,13,22,2,37
Cyphomyrus discorhynchus,16688,13,22,2,37
Paramormyrops gabonensis,16758,13,22,2,37
Sinibotia superciliaris,16572,13,22,2,37
Procecidochares utilis,15922,13,22,2,37
Equus zebra,16405,13,22,2,37
Rhynchocypris lagowskii,16599,13,22,2,37
Phoxinus steindachneri,16597,13,22,2,37
Rhynchocypris percnurus,16600,13,22,2,37
Rhynchocypris percnurus sachalinensis,16599,13,22,2,37
Chrosomus eos,16600,13,22,2,37
Megalobrama terminalis,16623,13,22,2,37
Oreoleuciscus potanini,16602,13,22,2,37
Phoxinus oxycephalus jouyi,16607,13,22,2,37
Tribolodon brandtii,16598,13,22,2,37
Tribolodon hakonensis,16602,13,22,2,37
Tribolodon sachalinensis,16597,13,22,2,37
Aelurostrongylus abstrusus,13913,12,22,2,36
Biston panterinaria,15517,13,22,2,37
Asiotmethis zacharjini,15660,13,22,2,37
Filchnerella helanshanensis,15657,13,22,2,37
Pseudotmethis rubimarginis,15661,13,22,2,37
Homarus gammarus,14316,12,19,2,33
Procambarus fallax,15253,13,22,2,37
Scyllarides latus,15663,13,22,2,37
Upogebia pusilla,15680,13,22,2,37
Neopetrolisthes maculatus,15324,13,22,2,37
Enoplometopus occidentalis,15111,12,19,2,33
Candida albicans,33928,14,24,2,40
Sturnus sericeus,16823,13,22,2,37
Emberiza tristrami,16789,13,22,2,37
Epthianura albifrons,16868,13,22,2,37
Eopsaltria australis,16768,13,22,2,37
Petroica boodang,16844,13,22,2,37
Petroica goodenovii,16891,13,22,2,37
Petroica phoenicea,16873,13,22,2,37
Grus virgo,16541,13,22,2,37
Grus leucogeranus,16688,13,22,2,37
Grus japonensis,16715,13,22,2,37
Grus americana,16651,13,22,2,37
Grus grus,16649,13,22,2,37
Grus nigricollis,16646,13,22,2,37
Antigone rubicunda,16693,13,22,2,37
Antigone antigone,16549,13,22,2,37
Antigone canadensis,16697,13,22,2,37
Addax nasomaculatus,16751,13,22,2,37
Aepyceros melampus,16422,13,22,2,37
Alcelaphus buselaphus,16373,13,22,2,37
Alces alces,16417,13,22,2,37
Antidorcas marsupialis,16444,13,22,2,37
Antilocapra americana,16352,13,22,2,37
Axis axis,16349,13,22,2,37
Axis porcinus,16375,13,22,2,37
Blastocerus dichotomus,16359,13,22,2,37
Capra caucasica,16624,13,22,2,37
Capreolus capreolus,16358,13,22,2,37
Cephalophus adersi,16435,13,22,2,37
Cephalophus callipygus,16427,13,22,2,37
Cephalophus dorsalis,16434,13,22,2,37
Cephalophus jentinki,16425,13,22,2,37
Cephalophus leucogaster,16427,13,22,2,37
Cephalophus natalensis,16429,13,22,2,37
Cephalophus nigrifrons,16431,13,22,2,37
Cephalophus ogilbyi,16426,13,22,2,37
Cephalophus rufilatus,16431,13,22,2,37
Cephalophus silvicultor,16426,13,22,2,37
Cephalophus spadix,16430,13,22,2,37
Cephalorhynchus heavisidii,16371,13,22,2,37
Hexaprotodon liberiensis,16396,13,22,2,37
Connochaetes gnou,16412,13,22,2,37
Connochaetes taurinus,16410,13,22,2,37
Dama dama,16330,13,22,2,37
Dorcatragus megalotis,16378,13,22,2,37
Eudorcas rufifrons,16418,13,22,2,37
Gazella bennettii,16435,13,22,2,37
Gazella cuvieri,16427,13,22,2,37
Gazella dorcas,16432,13,22,2,37
Gazella erlangeri,16434,13,22,2,37
Gazella gazella,16447,13,22,2,37
Gazella leptoceros,16439,13,22,2,37
Gazella spekei,16440,13,22,2,37
Gazella subgutturosa,16433,13,22,2,37
Hippocamelus antisensis,16410,13,22,2,37
Hippotragus equinus,16436,13,22,2,37
Hippotragus niger,16507,13,22,2,37
Hyemoschus aquaticus,16225,13,22,2,37
Kobus ellipsiprymnus,16427,13,22,2,37
Litocranius walleri,16438,13,22,2,37
Madoqua kirkii,16468,13,22,2,37
Madoqua saltiana,16402,13,22,2,37
Mazama americana,16478,13,22,2,37
Mazama gouazoupira,16355,13,22,2,37
Mazama rufina,16429,13,22,2,37
Naemorhedus baileyi,16448,13,22,2,37
Naemorhedus griseus,16448,13,22,2,37
Nanger dama,16377,13,22,2,37
Nanger granti,16381,13,22,2,37
Nanger soemmerringii,16379,13,22,2,37
Neotragus batesi,16389,13,22,2,37
Neotragus moschatus,16399,13,22,2,37
Odocoileus hemionus,16482,13,22,2,37
Okapia johnstoni,16422,13,22,2,37
Oreotragus oreotragus,16526,13,22,2,37
Oryx leucoryx,16680,13,22,2,37
Ourebia ourebi,16392,13,22,2,37
Pelea capreolus,16589,13,22,2,37
Philantomba maxwellii,16440,13,22,2,37
Philantomba monticola,16451,13,22,2,37
Potamochoerus porcus,16693,13,22,2,37
Procapra gutturosa,16546,13,22,2,37
Pudu mephistophiles,16426,13,22,2,37
Pudu puda,16347,13,22,2,37
Raphicerus campestris,16392,13,22,2,37
Redunca fulvorufula,16434,13,22,2,37
Rucervus duvaucelii,16342,13,22,2,37
Rusa alfredi,16355,13,22,2,37
Rusa timorensis,16434,13,22,2,37
Saiga tatarica,16375,13,22,2,37
Sylvicapra grimmia,16437,13,22,2,37
Tragelaphus angasii,16399,13,22,2,37
Tragelaphus eurycerus,16349,13,22,2,37
Tragelaphus oryx,16397,13,22,2,37
Tragelaphus scriptus,16402,13,22,2,37
Tragelaphus strepsiceros,16382,13,22,2,37
Tragulus kanchil,16333,13,22,2,37
Nannospalax galili,16409,13,22,2,37
Nannospalax judaei,16406,13,22,2,37
Spalax carmeli,16408,13,22,2,37
Nannospalax golani,16402,13,22,2,37
Loxodonta cyclotis,16109,13,22,2,37
Coregonus nasus,16739,13,22,2,37
Stenodus leucichthys,16864,13,22,2,37
Coregonus clupeaformis,16744,13,22,2,37
Prosopium williamsoni,16754,13,22,2,37
Prosopium cylindraceum,16526,13,22,2,37
Coregonus oxyrinchus,16737,13,22,2,37
Ozotoceros bezoarticus,16357,13,22,2,37
Anopheles cracens,15412,13,22,2,37
Anopheles hinesorum,15336,13,22,2,37
Anopheles farauti No. 4,15412,13,22,2,37
Tristira magellanica,16494,13,22,2,37
Lentula callani,15944,13,22,2,37
Lithidiopsis carinatus,15652,13,22,2,37
Pyrgacris descampsi,15618,13,22,2,37
Tanaocerus koebelei,15515,13,22,2,37
Ommexecha virens,15536,13,22,2,37
Rupicapra pyrenaica,16438,13,22,2,37
Potamopyrgus antipodarum,15110,13,22,2,37
Polypterus endlicherii,16632,13,22,2,37
Oryx beisa,16518,13,22,2,37
Redunca arundinum,16439,13,22,2,37
Balearica regulorum,16802,13,22,2,37
Balearica pavonina,16786,13,22,2,37
Grus carunculatus,16677,13,22,2,37
Grus paradisea,16696,13,22,2,37
Grus monacha,16650,13,22,2,37
Bambusicola fytchii,16726,13,22,2,37
Arborophila rufogularis,16726,13,22,2,37
Alectoris chukar,16686,13,22,2,37
Tragopan temminckii,16728,13,22,2,37
Pucrasia macrolopha,16696,13,22,2,37
Perdix dauurica,16695,13,22,2,37
Lophophorus sclateri,16707,13,22,2,37
Chrysolophus amherstiae,16677,13,22,2,37
Tetrastes bonasia,16673,13,22,2,37
Tachycineta bicolor,17945,13,22,2,37
Tachycineta thalassina,18118,13,22,2,37
Tachycineta euchrysea,17929,13,22,2,37
Tachycineta cyaneoviridis,18154,13,22,2,37
Tachycineta stolzmanni,17932,13,22,2,37
Tachycineta albilinea,17923,13,22,2,37
Tachycineta albiventer,17916,13,22,2,37
Tachycineta leucorrhoa,17965,13,22,2,37
Tachycineta meyeni,18012,13,22,2,37
Progne chalybea,18030,13,22,2,37
Schizothorax waltoni,16589,13,22,2,37
Tetraophasis szechenyii,16709,13,22,2,37
Boselaphus tragocamelus,16322,13,22,2,37
Pseudoryx nghetinhensis,16358,13,22,2,37
Syncerus caffer,16359,13,22,2,37
Taurotragus derbianus,16399,13,22,2,37
Tragelaphus imberbis,16405,13,22,2,37
Tragelaphus spekii,16408,13,22,2,37
Arabitragus jayakari,16457,13,22,2,37
Capra falconeri,16640,13,22,2,37
Capra ibex,16716,13,22,2,37
Capra nubiana,16705,13,22,2,37
Capra pyrenaica,16561,13,22,2,37
Capra sibirica,16583,13,22,2,37
Damaliscus pygargus,16385,13,22,2,37
Hemitragus jemlahicus,16712,13,22,2,37
Capricornis sumatraensis,16441,13,22,2,37
Oreamnos americanus,16604,13,22,2,37
Ovibos moschatus,16431,13,22,2,37
Pseudois nayaur,16737,13,22,2,37
Rupicapra rupicapra,16434,13,22,2,37
Pseudohynobius puxiongensis,16398,13,22,2,37
Pseudohynobius flavomaculatus,16389,13,22,2,37
Pseudolestes mirabilis,15122,13,22,2,37
Mustela sibirica,16559,13,22,2,37
Mustela putorius,16523,13,22,2,37
Mustela nivalis,16512,13,22,2,37
Mustela frenata,16543,13,22,2,37
Neovison vison,16552,13,22,2,37
Martes americana,16514,13,22,2,37
Martes foina,16530,13,22,2,37
Melogale moschata,16587,13,22,2,37
Arctonyx collaris,16481,13,22,2,37
Taxidea taxus,16425,13,22,2,37
Nasua nasua,16388,13,22,2,37
Mephitis mephitis,16538,13,22,2,37
Hynobius yiwuensis,16494,13,22,2,37
Hynobius nebulosus,16447,13,22,2,37
Polypterus ansorgii,16627,13,22,2,37
Polypterus delhezi,16557,13,22,2,37
Polypterus retropinnis,16637,13,22,2,37
Polypterus teugelsi,16616,13,22,2,37
Polypterus weeksii,16619,13,22,2,37
Ovis ammon,16613,13,22,2,37
Anopheles albitarsis,15413,13,22,2,37
Anopheles deaneorum,15424,13,22,2,37
Martes pennanti,16288,13,22,2,37
Notochelys platynota,16981,13,22,2,37
Procolobus verus,16605,13,22,2,37
Simias concolor,16561,13,22,2,37
Heosemys annandalii,16604,13,22,2,37
Hyaena hyaena,17112,13,22,2,37
Crocuta crocuta,17138,13,22,2,37
Gasterochisma melampus,16505,13,22,2,37
Thunnus tonggol,16528,13,22,2,37
Tetracerus quadricornis,16343,13,22,2,37
Homarus americanus,16432,13,22,2,37
Glycine max,402558,88,19,3,110
Octodon degus,16798,13,22,2,37
Cacatua moluccensis,16828,13,22,2,37
Calyptorhynchus lathami,16841,13,22,2,37
Zanda baudinii,16841,13,22,2,37
Zanda latirostris,16841,13,22,2,37
Ctenomys sociabilis,17016,13,22,2,37
Spalacopus cyanus,16830,13,22,2,37
Tympanoctomys barrerae,16863,13,22,2,37
Clathrina clathrus,9406,2,2,1,5
Clathrina clathrus,9270,4,2,0,6
Clathrina clathrus,8870,3,0,0,3
Clathrina clathrus,7920,3,8,0,11
Clathrina clathrus,8958,1,7,4,12
Clathrina clathrus,5596,0,4,4,8
Pleodorina starrii,20375,10,3,12,25
Concholepas concholepas,15495,13,22,2,37
Calanus hyperboreus,17910,13,22,2,37
Trematocranus placodon,16579,13,22,2,37
Diplotaxodon limnothrissa,16579,13,22,2,37
Petrotilapia nigra,16583,13,22,2,37
Nimbochromis linni,16584,13,22,2,37
Pseudotropheus crabro,16584,13,22,2,37
Astatotilapia calliptera,16578,13,22,2,37
Dimidiochromis compressiceps,16583,13,22,2,37
Genyochromis mento,16583,13,22,2,37
Rhamphochromis esox,16583,13,22,2,37
Cynotilapia afra,16585,13,22,2,37
Cheilochromis euchilus,16582,13,22,2,37
Gekko swinhonis,16818,13,22,2,37
Sarcocheilichthys parvus,16677,13,22,2,37
Scaphiodonichthys acanthopterus,16612,13,22,2,37
Rastrelliger kanagurta,16537,13,22,2,37
Pelochelys cantorii,17499,13,22,2,37
Chauliops fallax,15739,13,22,2,37
Vigna angularis,404466,26,16,3,45
Telatrygon zugei,18264,13,22,2,37
Rasbora steineri,16530,13,22,2,37
Channa maculata,16559,13,22,2,37
Channa argus x Channa maculata,16558,13,22,2,37
Coreius guichenoti,16612,13,22,2,37
Coreius heterodon,16611,13,22,2,37
Sinibrama macrops,16626,13,22,2,37
Acrossocheilus wenchowensis,16591,13,22,2,37
Alauda arvensis,17018,13,22,2,37
Schizothorax macropogon,16588,13,22,2,37
Psenes cyanophrys,16500,13,22,2,37
Flammulina velutipes,88508,31,26,2,59
Neopyropia tenera,42268,29,23,1,53
Jakoba bahamiensis,65327,68,26,3,97
Seculamonas ecuadoriensis,69158,68,27,3,98
Epinephelus moara,16696,13,22,2,37
Timelaea maculata,15178,13,22,2,37
Naegleria fowleri,49531,46,21,2,69
Taenia twitchelli,13519,12,22,2,36
Paphnutius ruficeps,14841,13,22,2,37
Salamandrella tridactyla,16342,13,22,2,37
Bursaphelenchus mucronatus,14583,12,22,2,36
Eospalax fontanierii cansus,16354,13,22,2,37
Spirocerca lupi,13780,12,22,2,36
Taenia ovis,13704,12,22,2,36
Taenia madoquae,13689,12,22,2,36
Taenia laticollis,13483,12,22,2,36
Echinococcus felidis,13632,12,22,2,36
Antigone vipio,16678,13,22,2,37
Apalone spinifera,16749,13,22,2,37
Mactra antiquata,17199,12,22,2,36
Mecopoda niponensis,15364,13,22,2,37
Mecopoda elongata,15284,13,22,2,37
Naemorhedus goral,16555,13,22,2,37
Songmachilis xinxiangensis,15473,13,22,2,37
Osteochilus salsburyi,16599,13,22,2,37
Chinchilla lanigera,16580,13,22,2,37
Coendou insidiosus,16571,13,22,2,37
Scomberomorus munroi,16796,13,22,2,37
Scomberomorus semifasciatus,16548,13,22,2,37
Scomberomorus munroi x Scomberomorus semifasciatus,16538,13,22,2,37
Pseudobagrus crassilabris,16534,13,22,2,37
Adoxophyes orana,15343,13,22,2,37
Tarragoilus diuturnus,16144,13,22,2,37
Crocidura shantungensis,17160,13,22,2,37
Apis florea,17694,13,24,2,39
Protobothrops jerdonii,17239,13,22,2,37
Thyridosmylus langii,16221,13,22,2,37
Sinochlora longifissa,18133,13,22,2,37
Ziphius cavirostris,16349,13,22,2,37
Sander canadensis,16542,13,22,2,37
Danaus plexippus,15314,13,22,2,37
Pentaceros wheeleri,16503,13,21,2,36
Python bivittatus,17617,13,22,2,37
Taenia serialis,13688,12,22,2,36
Paralithodes brevipes,16303,13,20,2,35
Hexagrammos agrammus,16514,13,21,2,36
Neophocaena phocaenoides,16385,13,22,2,37
Botryllus schlosseri,14928,13,27,2,42
Ascidiella aspersa,17146,13,26,2,41
Pygoscelis antarcticus,15972,13,22,2,37
Gomphocerus sibiricus,15590,13,22,2,37
Halocynthia spinosa,15074,13,24,2,39
Pyura gangelion,14418,13,24,2,39
Polycarpa mytiligera,14424,13,24,2,39
Aquarius paludum,15380,13,22,2,37
Trebouxiophyceae sp. MX-AZ01,74423,41,23,3,67
Clupanodon thrissa,16692,13,22,2,37
Leptobotia elongata,16591,13,22,2,37
Glyptothorax fokiensis fokiensis,16530,13,22,2,37
Chondracris rosea,15646,13,22,2,37
Pelodytes cf. punctatus II-2011,18905,13,22,2,37
Trachidermus fasciatus,16536,13,22,2,37
Rozella allomycis,12055,8,4,2,14
Potamopyrgus estuarinus,15120,13,22,2,37
Gagata dolichonema,16538,13,22,2,37
Glyptosternon maculatum,16539,13,22,2,37
Euchiloglanis kishinouyei,16561,13,22,2,37
Glaridoglanis andersonii,16532,13,22,2,37
Exostoma labiatum,16542,13,22,2,37
Liobagrus anguillicauda,16536,13,22,2,37
Pseudexostoma yunnanense,16598,13,22,2,37
Pseudecheneis sulcata,16474,13,22,2,37
Bagarius yarrelli,16503,13,22,2,37
Oreoglanis macropterus,16568,13,22,2,37
Glyptothorax trilineatus,16539,13,22,2,37
Xenocatantops brachycerus,15605,13,22,2,37
Shirakiacris shirakii,15649,13,22,2,37
Eleutheronema tetradactylum,16470,13,22,2,37
Remiz consobrinus,16737,13,22,2,37
Ascaridia galli,13977,12,22,2,36
Ascaridia columbae,13931,12,22,2,36
Onychostoma barbatulum,16597,13,22,2,37
Abisara fylloides,15301,13,22,2,37
Nilaparvata lugens,17619,13,24,2,39
Pentaceros japonicus,16506,13,22,2,37
Schedophilus velaini,16571,13,22,2,37
Lacerta agilis,17090,13,22,2,37
Neotrygon kuhlii,18039,13,22,2,37
Pseudorasbora elongata,16587,13,22,2,37
Pareuchiloglanis gracilicaudata,16588,13,22,2,37
Cermatobius longicornis,16833,13,22,2,37
Plectropomus areolatus,16770,13,22,2,37
Liobagrus nigricauda,16512,13,22,2,37
Emberiza pusilla,16790,13,22,2,37
Schizopygopsis younghusbandi,16674,13,22,2,37
Ctenoplusia agnata,15261,13,22,2,37
Bombina microdeladigitora,18256,13,22,2,37
Bombina lichuanensis,18554,13,22,2,37
Hemitrygon bennettii,17668,13,22,2,37
Schizothorax wangchiachii,16593,13,22,2,37
Gobiobotia naktongensis,16609,13,22,2,37
Lethenteron camtschaticum,16277,13,22,2,37
Ctenopharyngodon idella x Squaliobarbus curriculus,16609,13,22,2,37
Perinereis nuntia,15824,13,22,2,37
Lanius tephronotus,16820,13,22,2,37
Murina ussuriensis,17285,13,22,2,37
Ammodytes personatus,16537,13,22,2,37
Artemia urmiana,15945,13,22,2,37
Artemia tibetiana,15742,13,22,2,37
Raja rhina,16910,13,22,2,37
Plecturocebus cupreus,16551,13,22,2,37
Cacajao calvus,16702,13,22,2,37
Scatophagus argus,16783,13,22,2,37
Onychostoma simum,16601,13,22,2,37
Squaliobarbus curriculus x Ctenopharyngodon idella,16616,13,22,2,37
Saimiri boliviensis,16471,13,22,2,37
Ogataea thermophila,53262,25,25,2,52
Candida saraburiensis,32135,18,25,2,45
Candida buenavistaensis,46389,14,24,2,40
Diddensiella santjacobensis,64525,17,26,2,45
Candida pseudojiufengensis,33625,16,24,2,42
Candida tetrigidarum,52426,15,25,2,42
Pichia kluyveri,43128,26,26,2,54
Barnettozyma californica,48471,25,24,2,51
Candida oxycetoniae,62593,25,24,2,51
Cyberlindnera jadinii,41644,23,25,2,50
[Candida] vartiovaarae,33201,18,25,2,45
Ogataea philodendri,27063,14,25,2,41
Wickerhamomyces pijperi,23268,9,25,2,36
Cyberlindnera suaveolens,51521,29,25,2,56
[Candida] sake,26205,17,25,2,44
Candida theae,26234,17,24,2,43
Candida labiduridarum,39443,21,24,2,47
Wickerhamomyces mucosus,46416,26,25,2,53
Candida corydali,46389,25,24,2,51
Candida gigantensis,55125,27,32,2,61
[Candida] norvegica,42180,21,24,2,47
Gillichthys seta,16481,13,22,2,37
Meyerozyma guilliermondii,31070,20,25,2,47
Candida tropicalis,54610,18,24,2,44
Clavispora lusitaniae,24896,18,25,2,45
Ganoderma lucidum,60635,22,26,2,50
Cylicocyclus insigne,13828,12,22,2,36
Laminaria hyperborea,37976,38,23,3,64
Saccharina longissima,37628,38,24,3,65
Conogethes punctiferalis,15355,13,22,2,37
Ixodes ricinus,14566,13,22,2,37
Nannochloropsis granulata,38791,35,26,2,63
Microchloropsis salina,41907,36,26,2,64
Nannochloropsis limnetica,38543,35,26,2,63
Nannochloropsis oculata,38444,35,26,2,63
Tanakia koreensis,16563,13,22,2,37
Acheilognathus intermedia,16610,13,22,2,37
